a295blaster_b.dds	Mod	['ri_stormtrooper.alo']
a295blaster_c.dds	Mod	['ri_stormtrooper.alo']
ahsokatano_body.dds	Mod	['ri_rebel_jedi_ahsoka_tano.alo']
ahsokatano_face.dds	Mod	['ri_rebel_jedi_ahsoka_tano.alo']
ahsokatano_w.dds	Mod	['ri_rebel_jedi_ahsoka_tano.alo']
allegiance.dds	Unused?	[]
allegiance_b.dds	Unused?	[]
anakin_skywalker_jedi_knight_face.dds	Mod	['anakin_skywalker_dark.alo']
anakin_skywalker_jedi_knight_robes.dds	Mod	['anakin_skywalker_dark.alo']
assault_frigate.dds	Unused?	[]
assault_frigate_b.dds	Unused?	[]
balrus.dds	Unused?	[]
balrus_b.dds	Unused?	[]
battle_summary.dds	Unused?	[]
bf2_clone_bigl_rifle.dds	Unused?	[]
blueemissioncircle.dds	Mod	['ev_bellator_star_dreadnought.alo']
blueflash.dds	Mod	['mi_death_watch_lieutenant.alo', 'mi_supercommando_captain.alo', 'rep_clonetrooper_p2_heavy.alo', 'rep_commando.alo', 'ri_rebel_sniper_snow.alo', 'ri_rebel_sniper_urban.alo']
bluethruster.dds	Unused?	[]
blue_diver.dds	Unused?	[]
blue_diver_b.dds	Unused?	[]
blue_diver_l.dds	Unused?	[]
bobafett_14r_rifle.dds	Mod	['ri_dyn_jarren_the_mandalorian.alo']
build_backdrop.dds	Mod	['planetary_mode.alo', 'planetary_mode_overlay.alo']
cha_rebelsoldierbody_b.dds	Mod	['ri_stormtrooper.alo']
cha_rebelsoldierbody_c.dds	Mod	['ri_stormtrooper.alo']
cha_rebelsoldierhead_b.dds	Mod	['ri_stormtrooper.alo']
cha_rebelsoldierhead_c.dds	Mod	['ri_stormtrooper.alo']
chewbacca_bf2.dds	Mod	['ri_dyn_jarren_the_mandalorian.alo']
cis_b1_assault.dds	Mod	['cis_b1_assault.alo']
cis_b1_battledroid.dds	Unused?	[]
cis_b1_battledroid_b.dds	Mod	['cis_b1_assault.alo']
cis_b1_battledroid_pack.dds	Mod	['cis_b1_assault.alo']
cis_b1_battledroid_pack_b.dds	Mod	['cis_b1_assault.alo']
cis_b1_droid_backpack.dds	Mod	['cis_b1_commander_oom.alo']
cis_b1_droid_backpack_n.dds	Mod	['cis_b1_commander_oom.alo']
cis_b1_droid_limbs.dds	Mod	['cis_b1_commander_oom.alo']
cis_b1_droid_limbs_n.dds	Mod	['cis_b1_commander_oom.alo']
cis_b1_heavy_backpack.dds	Mod	['cis_b1_heavy.alo']
cis_b1_heavy_backpack_n.dds	Mod	['cis_b1_heavy.alo', 'cis_b1_heavy_geo.alo']
cis_b1_heavy_geo_backpack.dds	Mod	['cis_b1_heavy_geo.alo']
cis_b1_heavy_geo_head.dds	Mod	['cis_b1_heavy_geo.alo']
cis_b1_heavy_geo_limbs.dds	Mod	['cis_b1_heavy_geo.alo']
cis_b1_heavy_geo_torso.dds	Mod	['cis_b1_heavy_geo.alo']
cis_b1_heavy_head.dds	Mod	['cis_b1_heavy.alo']
cis_b1_heavy_head_n.dds	Mod	['cis_b1_heavy.alo', 'cis_b1_heavy_geo.alo', 'cis_b1_specialist.alo']
cis_b1_heavy_limbs.dds	Mod	['cis_b1_heavy.alo']
cis_b1_heavy_limbs_n.dds	Mod	['cis_b1_heavy.alo', 'cis_b1_heavy_geo.alo', 'cis_b1_specialist.alo']
cis_b1_heavy_torso.dds	Mod	['cis_b1_heavy.alo']
cis_b1_heavy_torso_n.dds	Mod	['cis_b1_heavy.alo', 'cis_b1_heavy_geo.alo', 'cis_b1_specialist.alo']
cis_b1_oom_geo_head.dds	Unused?	[]
cis_b1_oom_geo_torso.dds	Unused?	[]
cis_b1_oom_head.dds	Mod	['cis_b1_commander_oom.alo']
cis_b1_oom_head_n.dds	Mod	['cis_b1_commander_oom.alo']
cis_b1_oom_limbs.dds	Mod	['cis_b1_commander_oom.alo']
cis_b1_oom_torso.dds	Mod	['cis_b1_commander_oom.alo']
cis_b1_oom_torso_n.dds	Mod	['cis_b1_commander_oom.alo']
cis_b1_sniper_geo_head.dds	Unused?	[]
cis_b1_sniper_geo_limbs.dds	Unused?	[]
cis_b1_sniper_geo_torso.dds	Unused?	[]
cis_b1_sniper_head.dds	Mod	['cis_b1_specialist.alo']
cis_b1_sniper_limbs.dds	Mod	['cis_b1_specialist.alo']
cis_b1_sniper_torso.dds	Mod	['cis_b1_specialist.alo']
cis_b2_battledroid_cannon.dds	Mod	['cis_b2_ha _battledroid.alo']
cis_b2_battledroid_cannon_n.dds	Mod	['cis_b2_ha _battledroid.alo']
cis_b2_bust.dds	Mod	['cis_b2droid.alo']
cis_b2_bust_n.dds	Mod	['cis_b2droid.alo']
cis_b2_leg.dds	Mod	['cis_b2droid.alo']
cis_b2_leg_n.dds	Mod	['cis_b2droid.alo']
cis_b2_waist.dds	Mod	['cis_b2droid.alo']
cis_b2_waist_n.dds	Mod	['cis_b2droid.alo']
cis_battledroid_adv_arms.dds	Unused?	[]
cis_battledroid_adv_arms_n.dds	Unused?	[]
cis_battledroid_adv_head.dds	Unused?	[]
cis_battledroid_adv_head_n.dds	Unused?	[]
cis_battledroid_adv_legs.dds	Unused?	[]
cis_battledroid_adv_legs_n.dds	Unused?	[]
cis_battledroid_adv_pack.dds	Unused?	[]
cis_battledroid_adv_pack_n.dds	Unused?	[]
cis_battledroid_arms.dds	Mod	['cis_b1_battledroid.alo']
cis_battledroid_arms_n.dds	Mod	['cis_b1_battledroid.alo', 'cis_b1_battledroid_geo_heavy.alo', 'cis_b1_battledroid_grenadier.alo', 'cis_b1_battledroid_heavy.alo']
cis_battledroid_arms_security.dds	Unused?	[]
cis_battledroid_arms_security_n.dds	Unused?	[]
cis_battledroid_assassins_arms.dds	Unused?	[]
cis_battledroid_assassins_arms_n.dds	Unused?	[]
cis_battledroid_assassins_head.dds	Unused?	[]
cis_battledroid_assassins_head_n.dds	Unused?	[]
cis_battledroid_assassins_legs.dds	Unused?	[]
cis_battledroid_assassins_legs_n.dds	Unused?	[]
cis_battledroid_assassins_pack.dds	Unused?	[]
cis_battledroid_assassins_pack_n.dds	Unused?	[]
cis_battledroid_b2.dds	Mod	['cis_b2_ha _battledroid.alo']
cis_battledroid_b2_extras.dds	Unused?	[]
cis_battledroid_b2_extras_imperial.dds	Unused?	[]
cis_battledroid_b2_extras_mando.dds	Unused?	[]
cis_battledroid_b2_extras_n.dds	Unused?	[]
cis_battledroid_b2_extras_training.dds	Unused?	[]
cis_battledroid_b2_grapple.dds	Mod	['cis_b2_grapple_battledroid.alo']
cis_battledroid_b2_grappleweapon.dds	Mod	['cis_b2_grapple_battledroid.alo']
cis_battledroid_b2_grappleweapon_e.dds	Mod	['cis_b2_grapple_battledroid.alo', 'cis_b2_grapple_battledroid_red.alo']
cis_battledroid_b2_grappleweapon_n.dds	Mod	['cis_b2_grapple_battledroid.alo']
cis_battledroid_b2_grappleweapon_red.dds	Mod	['cis_b2_grapple_battledroid_red.alo']
cis_battledroid_b2_grappleweapon_red_n.dds	Mod	['cis_b2_grapple_battledroid_red.alo']
cis_battledroid_b2_grapple_blue_e.dds	Mod	['cis_b2_grapple_battledroid.alo']
cis_battledroid_b2_grapple_extras.dds	Mod	['cis_b2_grapple_battledroid.alo']
cis_battledroid_b2_grapple_extras_n.dds	Mod	['cis_b2_grapple_battledroid.alo']
cis_battledroid_b2_grapple_extras_red.dds	Mod	['cis_b2_grapple_battledroid_red.alo']
cis_battledroid_b2_grapple_extras_red_n.dds	Mod	['cis_b2_grapple_battledroid_red.alo']
cis_battledroid_b2_grapple_n.dds	Mod	['cis_b2_grapple_battledroid.alo']
cis_battledroid_b2_grapple_red.dds	Mod	['cis_b2_grapple_battledroid_red.alo']
cis_battledroid_b2_grapple_red_e.dds	Mod	['cis_b2_grapple_battledroid_red.alo']
cis_battledroid_b2_grapple_red_n.dds	Mod	['cis_b2_grapple_battledroid_red.alo']
cis_battledroid_b2_imperial.dds	Unused?	[]
cis_battledroid_b2_imperial_n.dds	Unused?	[]
cis_battledroid_b2_mando.dds	Unused?	[]
cis_battledroid_b2_mando_n.dds	Unused?	[]
cis_battledroid_b2_n.dds	Mod	['cis_b2_ha _battledroid.alo']
cis_battledroid_b2_rusty.dds	Unused?	[]
cis_battledroid_b2_rusty_extras.dds	Unused?	[]
cis_battledroid_b2_rusty_extras_n.dds	Unused?	[]
cis_battledroid_b2_rusty_n.dds	Unused?	[]
cis_battledroid_b2_training.dds	Unused?	[]
cis_battledroid_b2_training_n.dds	Unused?	[]
cis_battledroid_bones_bones.dds	Mod	['cis_b1_battledroid_grenadier.alo']
cis_battledroid_bones_bones_n.dds	Mod	['cis_b1_battledroid_grenadier.alo']
cis_battledroid_forest_arms.dds	Unused?	[]
cis_battledroid_forest_head.dds	Unused?	[]
cis_battledroid_forest_head_n.dds	Unused?	[]
cis_battledroid_forest_legs.dds	Unused?	[]
cis_battledroid_forest_legs_n.dds	Unused?	[]
cis_battledroid_forest_pack.dds	Unused?	[]
cis_battledroid_geo_arms.dds	Unused?	[]
cis_battledroid_geo_head.dds	Unused?	[]
cis_battledroid_geo_legs.dds	Unused?	[]
cis_battledroid_geo_oom_arms.dds	Unused?	[]
cis_battledroid_geo_pack.dds	Unused?	[]
cis_battledroid_grenadier_arms.dds	Mod	['cis_b1_battledroid_grenadier.alo']
cis_battledroid_grenadier_head.dds	Mod	['cis_b1_battledroid_grenadier.alo']
cis_battledroid_grenadier_head_n.dds	Mod	['cis_b1_battledroid_grenadier.alo']
cis_battledroid_grenadier_legs.dds	Mod	['cis_b1_battledroid_grenadier.alo']
cis_battledroid_grenadier_pack.dds	Mod	['cis_b1_battledroid_grenadier.alo']
cis_battledroid_head.dds	Mod	['cis_b1_battledroid.alo']
cis_battledroid_head_n.dds	Mod	['cis_b1_battledroid.alo']
cis_battledroid_head_security.dds	Unused?	[]
cis_battledroid_head_security_n.dds	Unused?	[]
cis_battledroid_heavy_arms.dds	Mod	['cis_b1_battledroid_heavy.alo']
cis_battledroid_heavy_geo_arms.dds	Mod	['cis_b1_battledroid_geo_heavy.alo']
cis_battledroid_heavy_geo_head.dds	Mod	['cis_b1_battledroid_geo_heavy.alo']
cis_battledroid_heavy_geo_legs.dds	Mod	['cis_b1_battledroid_geo_heavy.alo']
cis_battledroid_heavy_geo_pack.dds	Mod	['cis_b1_battledroid_geo_heavy.alo']
cis_battledroid_heavy_head.dds	Mod	['cis_b1_battledroid_heavy.alo']
cis_battledroid_heavy_head_n.dds	Mod	['cis_b1_battledroid_geo_heavy.alo', 'cis_b1_battledroid_heavy.alo']
cis_battledroid_heavy_legs.dds	Mod	['cis_b1_battledroid_heavy.alo']
cis_battledroid_heavy_legs_n.dds	Mod	['cis_b1_battledroid_geo_heavy.alo']
cis_battledroid_heavy_pack.dds	Mod	['cis_b1_battledroid_heavy.alo']
cis_battledroid_legs.dds	Mod	['cis_b1_battledroid.alo', 'cis_b1_battledroid_oom_pistol.alo', 'cis_b1_battledroid_specialist.alo']
cis_battledroid_legs_firefighter.dds	Unused?	[]
cis_battledroid_legs_firefighter_n.dds	Unused?	[]
cis_battledroid_legs_n.dds	Mod	['cis_b1_battledroid.alo', 'cis_b1_battledroid_grenadier.alo', 'cis_b1_battledroid_heavy.alo', 'cis_b1_battledroid_oom_pistol.alo', 'cis_b1_battledroid_specialist.alo']
cis_battledroid_mkiii_arms.dds	Unused?	[]
cis_battledroid_mkiii_body.dds	Unused?	[]
cis_battledroid_mkiii_head.dds	Unused?	[]
cis_battledroid_mkiii_head_n.dds	Unused?	[]
cis_battledroid_mkiii_legs.dds	Unused?	[]
cis_battledroid_mkiii_pack.dds	Unused?	[]
cis_battledroid_oom_arms.dds	Mod	['cis_b1_battledroid_oom_pistol.alo']
cis_battledroid_oom_arms_n.dds	Mod	['cis_b1_battledroid_oom_pistol.alo']
cis_battledroid_oom_forest_head.dds	Unused?	[]
cis_battledroid_oom_forest_head_n.dds	Unused?	[]
cis_battledroid_oom_geo_head.dds	Unused?	[]
cis_battledroid_oom_head.dds	Mod	['cis_b1_battledroid_oom_pistol.alo']
cis_battledroid_oom_head_n.dds	Mod	['cis_b1_battledroid_oom_pistol.alo']
cis_battledroid_pack.dds	Mod	['cis_b1_battledroid.alo', 'cis_b1_battledroid_oom_pistol.alo']
cis_battledroid_pack_n.dds	Mod	['cis_b1_battledroid.alo', 'cis_b1_battledroid_geo_heavy.alo', 'cis_b1_battledroid_grenadier.alo', 'cis_b1_battledroid_heavy.alo', 'cis_b1_battledroid_oom_pistol.alo']
cis_battledroid_rocket_arms.dds	Unused?	[]
cis_battledroid_rocket_arms_n.dds	Unused?	[]
cis_battledroid_specialist_arms.dds	Mod	['cis_b1_battledroid_specialist.alo']
cis_battledroid_specialist_arms_n.dds	Mod	['cis_b1_battledroid_specialist.alo']
cis_battledroid_specialist_head.dds	Mod	['cis_b1_battledroid_specialist.alo']
cis_battledroid_specialist_head_n.dds	Mod	['cis_b1_battledroid_specialist.alo']
cis_bulwarkmki.dds	Unused?	[]
cis_bulwarkmki_b.dds	Unused?	[]
cis_bx_commando.dds	Mod	['cis_bx_commando.alo', 'cis_bx_commando_captain.alo']
cis_bx_commando_captain.dds	Mod	['cis_bx_commando_captain.alo']
cis_bx_commando_n.dds	Mod	['cis_bx_commando.alo', 'cis_bx_commando_captain.alo']
cis_diamoncruiser.dds	Unused?	[]
cis_diamoncruiser_b.dds	Unused?	[]
cis_e5.dds	Mod	['cis_b1_battledroid.alo', 'cis_b1_commander_oom.alo', 'cis_bx_commando.alo', 'cis_bx_commando_captain.alo', 'resi_b1_battledroid.alo']
cis_e5c.dds	Mod	['cis_b1_battledroid_geo_heavy.alo', 'cis_b1_battledroid_heavy.alo', 'cis_b1_heavy.alo', 'cis_b1_heavy_geo.alo']
cis_e5c_n.dds	Mod	['cis_b1_battledroid_geo_heavy.alo', 'cis_b1_battledroid_heavy.alo', 'cis_b1_heavy.alo', 'cis_b1_heavy_geo.alo']
cis_e5g.dds	Mod	['cis_b1_battledroid_grenadier.alo']
cis_e5g_n.dds	Mod	['cis_b1_battledroid_grenadier.alo']
cis_e5s.dds	Mod	['cis_b1_battledroid_specialist.alo', 'cis_b1_specialist.alo']
cis_e5s_n.dds	Mod	['cis_b1_battledroid_specialist.alo', 'cis_b1_specialist.alo']
cis_e5_n.dds	Mod	['cis_b1_battledroid.alo', 'cis_b1_commander_oom.alo', 'cis_bx_commando.alo', 'cis_bx_commando_captain.alo', 'resi_b1_battledroid.alo']
cis_e_5_blaster.dds	Unused?	[]
cis_e_5_blaster_n.dds	Unused?	[]
cis_hangar_e.dds	Unused?	[]
cis_ig100.dds	Mod	['cis_ig100.alo']
cis_ig100_blue.dds	Mod	['cis_ig100_blue.alo']
cis_ig100_blue_n.dds	Mod	['cis_ig100.alo', 'cis_ig100_blue.alo']
cis_ig100_cape.dds	Mod	['cis_ig100.alo', 'cis_ig100_blue.alo']
cis_ig100_cape_n.dds	Mod	['cis_ig100.alo', 'cis_ig100_blue.alo']
cis_rg4d.dds	Mod	['cis_b1_battledroid_oom_pistol.alo']
cis_rg4d_n.dds	Mod	['cis_b1_battledroid_oom_pistol.alo']
cis_rocket_launcher.dds	Mod	['cis_b1_assault.alo']
cis_rocket_launcher_n.dds	Mod	['cis_b1_assault.alo']
cis_starbase_hull_diff.dds	Unused?	[]
cis_starbase_hull_norm.dds	Unused?	[]
cis_starbase_t2_diff.dds	Unused?	[]
cis_starbase_t2_norm.dds	Unused?	[]
cis_starbase_t3_diff.dds	Unused?	[]
cis_starbase_t3_norm.dds	Unused?	[]
cis_starbase_t4_antenna_diff.dds	Unused?	[]
cis_starbase_t4_antenna_norm.dds	Unused?	[]
cis_starbase_t4_panels_diff.dds	Unused?	[]
cis_starbase_t4_panels_norm.dds	Unused?	[]
cis_vibrosword.dds	Mod	['cis_bx_commando.alo', 'cis_bx_commando_captain.alo']
cis_vibrosword_n.dds	Mod	['cis_bx_commando.alo', 'cis_bx_commando_captain.alo']
clone_sniper_phase2_armorsilver.dds	Unused?	[]
connoreye.dds	Mod	['ri_stormtrooper.alo']
connoreye_n.dds	Mod	['ri_stormtrooper.alo']
conqueror_star_destroyer_bridge.dds	Unused?	[]
conqueror_star_destroyer_bridge_normal.dds	Unused?	[]
corona.dds	Unused?	[]
corona_b.dds	Unused?	[]
dauntless.dds	Unused?	[]
dauntless_b.dds	Unused?	[]
dc17mammo.dds	Mod	['rep_commando.alo']
dc17m_base.dds	Mod	['rep_commando.alo']
dc17m_base_n.dds	Mod	['rep_commando.alo']
dc17m_blaster_sniper.dds	Mod	['rep_commando.alo']
dc17m_blaster_sniper_n.dds	Mod	['rep_commando.alo']
dd6_blaster.dds	Mod	['ni_ithorian.alo', 'ni_ithorian_2.alo', 'ni_ithorian_3.alo', 'ni_ithorian_4.alo']
dh17blaster_c.dds	Mod	['ri_pilot.alo', 'ri_saboteur.alo']
dh17blaster_n.dds	Mod	['ri_pilot.alo', 'ri_saboteur.alo']
dominator-class_star_destroyer.dds	Unused?	[]
dominator-class_star_destroyer_normal.dds	Unused?	[]
dominator.dds	Mod	['empire_dominator.alo']
dominator_b.dds	Mod	['empire_dominator.alo']
dreadnaught.dds	Unused?	[]
dyn_jarren_armor.dds	Mod	['ri_dyn_jarren_the_mandalorian.alo']
dyn_jarren_helmet.dds	Mod	['ri_dyn_jarren_the_mandalorian.alo']
dyn_jarren_jetpack.dds	Mod	['ri_dyn_jarren_the_mandalorian.alo']
e11blaster_diffuse.dds	Mod	['ei_magmatrooper.alo', 'ei_shadow_trooper.alo', 'ei_trooper.alo', 'ei_trooper_sand.alo', 'ei_trooper_snow.alo']
e11blaster_normal.dds	Mod	['ei_magmatrooper.alo', 'ei_shadow_trooper.alo', 'ei_trooper.alo', 'ei_trooper_sand.alo', 'ei_trooper_snow.alo']
ei_armytrooper.dds	Unused?	[]
ei_armytrooper_01.dds	Mod	['ei_armytrooper.alo']
ei_armytrooper_02.dds	Mod	['ei_armytrooper.alo']
ei_armytrooper_02_medic.dds	Unused?	[]
ei_armytrooper_gloss.dds	Unused?	[]
ei_darktrooper.dds	Unused?	[]
ei_dc15le_mods.dds	Mod	['ei_purgetrooper_commander.alo']
ei_dc15le_mods_n.dds	Mod	['ei_purgetrooper_commander.alo']
ei_deathsquad_wep.dds	Mod	['ei_deathtrooper.alo']
ei_deathsquad_wep_n.dds	Mod	['ei_deathtrooper.alo']
ei_deathtrooper_body.dds	Mod	['ei_deathtrooper.alo']
ei_deathtrooper_body_n.dds	Mod	['ei_deathtrooper.alo']
ei_deathtrooper_gloves.dds	Mod	['ei_deathtrooper.alo']
ei_deathtrooper_gloves_n.dds	Mod	['ei_deathtrooper.alo']
ei_deathtrooper_helmet.dds	Mod	['ei_deathtrooper.alo']
ei_deathtrooper_helmet_n.dds	Mod	['ei_deathtrooper.alo']
ei_dlt19.dds	Mod	['ei_shocktrooper_heavy.alo']
ei_dlt19d.dds	Unused?	[]
ei_dlt19x_scope.dds	Unused?	[]
ei_dlt19x_scope_n.dds	Unused?	[]
ei_dlt19_n.dds	Mod	['ei_shocktrooper_heavy.alo']
ei_dlt20a.dds	Mod	['ri_rebel_sniper_snow.alo', 'ri_rebel_sniper_urban.alo']
ei_dlt20a_n.dds	Mod	['ri_rebel_sniper_snow.alo', 'ri_rebel_sniper_urban.alo']
ei_e11.dds	Mod	['ei_mustafartrooper.alo', 'ei_novatrooper.alo']
ei_e11_n.dds	Mod	['ei_mustafartrooper.alo', 'ei_novatrooper.alo']
ei_e22.dds	Mod	['ei_shoretrooper.alo']
ei_e22_n.dds	Mod	['ei_shoretrooper.alo']
ei_iden_armour.dds	Unused?	[]
ei_iden_armour_n.dds	Unused?	[]
ei_iden_body.dds	Unused?	[]
ei_iden_body_n.dds	Unused?	[]
ei_imperial_super_commando.dds	Mod	['ei_imperial_super_commando.alo']
ei_imperial_super_commandos_wp.dds	Mod	['ei_imperial_super_commando.alo']
ei_imperial_super_commandos_wp_n.dds	Mod	['ei_imperial_super_commando.alo']
ei_imperial_super_commando_head.dds	Mod	['ei_imperial_super_commando.alo']
ei_imperial_super_commando_head_n.dds	Mod	['ei_imperial_super_commando.alo']
ei_imperial_super_commando_n.dds	Mod	['ei_imperial_super_commando.alo']
ei_infernosquad_armour.dds	Unused?	[]
ei_infernosquad_armour2.dds	Unused?	[]
ei_infernosquad_armour_n.dds	Unused?	[]
ei_infernosquad_body.dds	Unused?	[]
ei_infernosquad_body_n.dds	Unused?	[]
ei_infernosquad_helmet.dds	Unused?	[]
ei_infernosquad_helmet_n.dds	Unused?	[]
ei_magmatrooper_backpack.dds	Mod	['ei_magmatrooper.alo']
ei_magmatrooper_backpack_n.dds	Mod	['ei_magmatrooper.alo']
ei_magmatrooper_pads.dds	Mod	['ei_magmatrooper.alo']
ei_magmatrooper_pads_n.dds	Mod	['ei_magmatrooper.alo']
ei_mudtrooper.dds	Mod	['ei_mudtrooper.alo']
ei_mudtrooper_cloak.dds	Mod	['ei_mudtrooper.alo']
ei_mudtrooper_cloak_n.dds	Mod	['ei_mudtrooper.alo']
ei_mudtrooper_hands.dds	Mod	['ei_mudtrooper.alo']
ei_mudtrooper_hands_n.dds	Mod	['ei_mudtrooper.alo']
ei_mudtrooper_n.dds	Mod	['ei_mudtrooper.alo']
ei_mudtrooper_weapon.dds	Mod	['ei_mudtrooper.alo']
ei_mudtrooper_weapon_n.dds	Mod	['ei_mudtrooper.alo']
ei_mustafartrooper_body.dds	Mod	['ei_mustafartrooper.alo']
ei_mustafartrooper_hand.dds	Mod	['ei_mustafartrooper.alo']
ei_mustafartrooper_helmet.dds	Mod	['ei_mustafartrooper.alo']
ei_mustafartrooper_paldron_white.dds	Mod	['ei_mustafartrooper.alo']
ei_novatrooper_body.dds	Mod	['ei_novatrooper.alo']
ei_novatrooper_hand.dds	Mod	['ei_novatrooper.alo']
ei_novatrooper_helmet.dds	Mod	['ei_novatrooper.alo']
ei_novatrooper_paldron_white.dds	Mod	['ei_novatrooper.alo']
ei_officer_boots.dds	Unused?	[]
ei_officer_collar.dds	Unused?	[]
ei_officer_face.dds	Unused?	[]
ei_officer_face_1.dds	Unused?	[]
ei_officer_face_2.dds	Unused?	[]
ei_officer_face_3.dds	Unused?	[]
ei_officer_face_4.dds	Unused?	[]
ei_officer_glove.dds	Unused?	[]
ei_officer_hand.dds	Unused?	[]
ei_officer_head.dds	Unused?	[]
ei_officer_head_black.dds	Unused?	[]
ei_officer_head_white.dds	Unused?	[]
ei_officer_hips.dds	Unused?	[]
ei_officer_hips_black.dds	Unused?	[]
ei_officer_hips_white.dds	Unused?	[]
ei_officer_legs.dds	Unused?	[]
ei_officer_legs_black.dds	Unused?	[]
ei_officer_mouth_eyes.dds	Unused?	[]
ei_officer_rankinsignia.dds	Unused?	[]
ei_officer_torso.dds	Unused?	[]
ei_officer_torso_black.dds	Unused?	[]
ei_officer_torso_white.dds	Unused?	[]
ei_palpatine.dds	Mod	['anakin_skywalker_dark.alo']
ei_purgetrooper_body.dds	Mod	['ei_purgetrooper_commander.alo']
ei_purgetrooper_body_n.dds	Mod	['ei_purgetrooper_commander.alo']
ei_purgetrooper_helmet.dds	Mod	['ei_purgetrooper_commander.alo']
ei_purgetrooper_helmet_n.dds	Mod	['ei_purgetrooper_commander.alo']
ei_purgetrooper_parts_commander.dds	Mod	['ei_purgetrooper_commander.alo']
ei_purgetrooper_parts_commander_n.dds	Mod	['ei_purgetrooper_commander.alo']
ei_purgetrooper_visor.dds	Mod	['ei_purgetrooper_commander.alo']
ei_rocket.dds	Mod	['ei_shocktrooper.alo', 'ei_shocktrooper_snow.alo']
ei_sandtrooper_backpack.dds	Mod	['ei_trooper_sand.alo']
ei_sandtrooper_backpack_n.dds	Mod	['ei_trooper_sand.alo']
ei_sandtrooper_pads.dds	Mod	['ei_trooper_sand.alo']
ei_sandtrooper_pads_n.dds	Mod	['ei_trooper_sand.alo']
ei_scouttrooperpistolbf.dds	Unused?	[]
ei_scouttrooper_body.dds	Unused?	[]
ei_scouttrooper_body_c.dds	Unused?	[]
ei_scouttrooper_body_n.dds	Unused?	[]
ei_scouttrooper_glove.dds	Unused?	[]
ei_scouttrooper_glove_c.dds	Unused?	[]
ei_scouttrooper_glove_n.dds	Unused?	[]
ei_scouttrooper_helmet.dds	Unused?	[]
ei_scouttrooper_helmet_c.dds	Unused?	[]
ei_scouttrooper_helmet_n.dds	Unused?	[]
ei_shadowst_diff.dds	Mod	['ei_shadow_trooper.alo']
ei_shadowst_norm.dds	Mod	['ei_shadow_trooper.alo']
ei_shockbackpack.dds	Mod	['ei_shocktrooper_heavy.alo']
ei_shockbackpack_n.dds	Mod	['ei_shocktrooper_heavy.alo']
ei_shockhelmet.dds	Mod	['ei_shocktrooper_heavy.alo']
ei_shockhelmet_n.dds	Mod	['ei_shocktrooper_heavy.alo']
ei_shocklowerbody.dds	Mod	['ei_shocktrooper_heavy.alo']
ei_shocklowerbody_n.dds	Mod	['ei_shocktrooper_heavy.alo']
ei_shockupperbody.dds	Mod	['ei_shocktrooper_heavy.alo']
ei_shockupperbody_n.dds	Mod	['ei_shocktrooper_heavy.alo']
ei_shoretrooper.dds	Mod	['ei_shoretrooper.alo']
ei_shoretrooper_captian.dds	Unused?	[]
ei_shoretrooper_captian_n.dds	Unused?	[]
ei_shoretrooper_hands.dds	Mod	['ei_shoretrooper.alo']
ei_shoretrooper_hands_n.dds	Mod	['ei_shoretrooper.alo']
ei_shoretrooper_helmet.dds	Mod	['ei_shoretrooper.alo']
ei_shoretrooper_helmet_n.dds	Mod	['ei_shoretrooper.alo']
ei_shoretrooper_n.dds	Mod	['ei_shoretrooper.alo']
ei_snowtrooper_backpack.dds	Mod	['ei_trooper_snow.alo']
ei_snowtrooper_backpack_n.dds	Mod	['ei_trooper_snow.alo']
ei_snowtrooper_body.dds	Mod	['ei_trooper_snow.alo']
ei_snowtrooper_body_n.dds	Mod	['ei_trooper_snow.alo']
ei_snowtrooper_hands.dds	Mod	['ei_trooper_snow.alo']
ei_snowtrooper_hands_n.dds	Mod	['ei_trooper_snow.alo']
ei_snowtrooper_helmet.dds	Mod	['ei_trooper_snow.alo']
ei_snowtrooper_helmet_n.dds	Mod	['ei_trooper_snow.alo']
ei_snowtrooper_kilt.dds	Mod	['ei_trooper_snow.alo']
ei_snowtrooper_kilt_n.dds	Mod	['ei_trooper_snow.alo']
ei_stormtrooper_body.dds	Mod	['ei_mustafartrooper.alo', 'ei_novatrooper.alo']
ei_stormtrooper_body_n.dds	Mod	['ei_mustafartrooper.alo', 'ei_novatrooper.alo', 'ri_stormtrooper_v3.alo']
ei_stormtrooper_hand.dds	Mod	['ri_stormtrooper_v3.alo']
ei_stormtrooper_hand_n.dds	Mod	['ei_mustafartrooper.alo', 'ei_novatrooper.alo', 'ri_stormtrooper_v3.alo']
ei_stormtrooper_helmet.dds	Mod	['ri_stormtrooper_v3.alo']
ei_stormtrooper_helmet_n.dds	Mod	['ei_mustafartrooper.alo', 'ei_novatrooper.alo', 'ri_stormtrooper_v3.alo']
ei_stormtrooper_paldron_n.dds	Mod	['ei_mustafartrooper.alo', 'ei_novatrooper.alo']
ei_thrawn.dds	Mod	['ei_thrawn.alo']
ei_thrawn_battle_gear.dds	Mod	['ei_thrawn.alo']
ei_thrawn_battle_gear_helmet.dds	Mod	['ei_thrawn.alo']
ei_thrawn_battle_gear_helmet_n.dds	Mod	['ei_thrawn.alo']
ei_thrawn_battle_gear_n.dds	Mod	['ei_thrawn.alo']
ei_thrawn_head.dds	Mod	['ei_thrawn.alo']
ei_thrawn_head_n.dds	Mod	['ei_thrawn.alo']
ei_thrawn_n.dds	Mod	['ei_thrawn.alo']
ei_vaderbody.dds	Mod	['ei_vader.alo']
ei_vaderbody_b.dds	Mod	['ei_vader.alo']
ei_vaderhelmet.dds	Mod	['ei_vader.alo']
ei_vaderhelmet_b.dds	Mod	['ei_vader.alo']
ei_vaderskirt.dds	Mod	['ei_vader.alo']
ei_vaderskirt_b.dds	Mod	['ei_vader.alo']
ei_vaders_saber.dds	Mod	['ei_vader.alo']
ei_vaders_saber_spec.dds	Mod	['ei_vader.alo']
ei_weap_inf_rifle.dds	Mod	['ei_armytrooper.alo']
empire_allegiance.dds	Mod	['empire_star_destroyer_allegiance.alo']
empire_allegiance_b.dds	Mod	['empire_star_destroyer_allegiance.alo']
empire_chimaera.dds	Mod	['empire_star_destroyer_chimaera.alo']
empire_imperator1.dds	Mod	['empire_dominator.alo', 'empire_star_destroyer2.alo', 'empire_star_destroyeri.alo', 'empire_star_destroyer_allegiance.alo', 'empire_tector.alo', 'ev_isd1.alo']
empire_imperator1_b.dds	Mod	['empire_dominator.alo', 'empire_star_destroyer2.alo', 'empire_star_destroyeri.alo', 'empire_star_destroyer_allegiance.alo', 'empire_star_destroyer_chimaera.alo', 'empire_tector.alo', 'ev_isd1.alo']
empire_imperator2.dds	Mod	['empire_procursator.alo']
empire_imperator2_b.dds	Mod	['empire_procursator.alo']
empire_shield_gate.dds	Mod	['empire_starbase_level_01.alo', 'empire_starbase_level_02.alo', 'empire_starbase_level_03.alo', 'empire_starbase_level_04.alo', 'empire_starbase_level_05.alo']
empire_shield_gate_b.dds	Mod	['empire_starbase_level_01.alo', 'empire_starbase_level_02.alo', 'empire_starbase_level_03.alo', 'empire_starbase_level_04.alo', 'empire_starbase_level_05.alo']
empire_tie_bomber.dds	Mod	['empire_tie_advanced.alo', 'empire_tie_bomber.alo']
empire_tie_bomber_b.dds	Mod	['empire_tie_advanced.alo', 'empire_tie_bomber.alo']
empire_tie_cockpit.dds	Mod	['empire_tie_advanced.alo', 'empire_tie_interceptor_royal.alo']
empire_tie_defender.dds	Mod	['empire_tie_advanced.alo', 'empire_tie_defender.alo', 'empire_tie_interceptor_royal.alo']
empire_tie_defender_b.dds	Mod	['empire_tie_defender.alo']
empire_tie_fighter.dds	Mod	['empire_tie_fighter.alo']
empire_tie_fighter_b.dds	Mod	['empire_tie_fighter.alo']
empire_tie_hunter.dds	Mod	['empire_tie_advanced.alo']
empire_tie_hunter_b.dds	Mod	['empire_tie_advanced.alo']
empire_tie_interceptor.dds	Mod	['empire_tie_advanced.alo', 'empire_tie_interceptor.alo', 'empire_tie_interceptor_royal.alo']
empire_tie_interceptor_b.dds	Mod	['empire_tie_advanced.alo', 'empire_tie_interceptor.alo', 'empire_tie_interceptor_royal.alo']
empire_tie_interceptor_royal.dds	Mod	['empire_tie_interceptor_royal.alo']
empire_tie_phantom.dds	Mod	['empire_tie_phantom.alo']
empire_tie_phantom_b.dds	Mod	['empire_tie_phantom.alo']
empire_vindicator.dds	Mod	['empire_procursator.alo', 'empire_vindicator.alo', 'vindicator.alo']
empire_vindicator_b.dds	Mod	['empire_procursator.alo', 'empire_vindicator.alo', 'vindicator.alo']
empire_vindicator_hangar.dds	Mod	['empire_vindicator.alo', 'vindicator.alo']
empire_vindicator_hangar_b.dds	Mod	['empire_vindicator.alo', 'vindicator.alo']
engine_glow_blue_dist.tga	Mod	['empire_dominator.alo', 'empire_star_destroyer2.alo', 'empire_tector.alo', 'engine.alo']
engine_glow_blue_wave.tga	Mod	['empire_dominator.alo', 'empire_star_destroyer2.alo', 'empire_tector.alo', 'engine.alo']
engine_glow_fancy_white.tga	Mod	['empire_dominator.alo', 'empire_star_destroyer2.alo', 'empire_tector.alo', 'engine.alo']
engine_glow_red.dds	Mod	['empire_tie_inquisitor.alo']
engine_glow_white.dds	Mod	['cis_bx_commando.alo', 'cis_bx_commando_captain.alo']
ev_acclamator_assault_ship.dds	Unused?	[]
ev_acclamator_assault_ship_b.dds	Unused?	[]
ev_aramadia_ssd.dds	Mod	['empire_vindicator.alo']
ev_aramadia_ssd_bumb.dds	Mod	['empire_vindicator.alo']
ev_atar.dds	Mod	['ev_atar.alo']
ev_atar_n.dds	Mod	['ev_atar.alo']
ev_atdp.dds	Mod	['ev_atar.alo']
ev_atdp_n.dds	Mod	['ev_atar.alo']
ev_at_dt.dds	Mod	['ev_at_dt.alo']
ev_at_dt_n.dds	Mod	['ev_at_dt.alo']
ev_bellatordetails2_base.dds	Unused?	[]
ev_bellatordetails2_normal.dds	Unused?	[]
ev_bellatordetails_base.dds	Mod	['ev_bellator_star_dreadnought.alo']
ev_bellatordetails_normal.dds	Mod	['ev_bellator_star_dreadnought.alo']
ev_bellatorgreebles_base.dds	Mod	['ev_bellator_star_dreadnought.alo']
ev_bellatorgreebles_normal.dds	Mod	['ev_bellator_star_dreadnought.alo']
ev_bellatorhullsuper_base.dds	Mod	['ev_bellator_star_dreadnought.alo']
ev_bellatorhullsuper_normal.dds	Mod	['ev_bellator_star_dreadnought.alo']
ev_bellatorhull_base.dds	Mod	['ev_bellator_star_dreadnought.alo']
ev_bellatorhull_normal.dds	Mod	['ev_bellator_star_dreadnought.alo']
ev_bellator_hullplates_base.dds	Mod	['ev_bellator_star_dreadnought.alo']
ev_bellator_hullplates_normal.dds	Mod	['ev_bellator_star_dreadnought.alo']
ev_enforcership.dds	Unused?	[]
ev_enforcership_b.dds	Unused?	[]
ev_immobilizer_details.dds	Mod	['ev_immobilizer.alo']
ev_immobilizer_details_b.dds	Mod	['ev_immobilizer.alo']
ev_immobilizer_engines.dds	Mod	['ev_immobilizer.alo']
ev_immobilizer_engines_b.dds	Mod	['ev_immobilizer.alo']
ev_immobilizer_greebles.dds	Mod	['ev_immobilizer.alo']
ev_immobilizer_greebles_b.dds	Mod	['ev_immobilizer.alo']
ev_immobilizer_hull.dds	Mod	['ev_immobilizer.alo']
ev_immobilizer_hull_b.dds	Mod	['ev_immobilizer.alo']
ev_immobilizer_windows.dds	Mod	['ev_immobilizer.alo']
ev_interdictor.dds	Unused?	[]
ev_interdictor_bc.dds	Unused?	[]
ev_navytrooper_01.dds	Mod	['ei_armytrooper.alo']
ev_navytrooper_02.dds	Mod	['ei_armytrooper.alo']
ev_tiestriker_body.dds	Mod	['ev_tiestriker.alo']
ev_tiestriker_body_n.dds	Mod	['ev_tiestriker.alo']
ev_tiestriker_wings.dds	Mod	['ev_tiestriker.alo']
ev_tiestriker_wings_n.dds	Mod	['ev_tiestriker.alo']
finalizer_sd.dds	Mod	['finalizer_star_destroyer.alo']
finalizer_sd_b.dds	Mod	['finalizer_star_destroyer.alo']
finalizer_sd_l.dds	Mod	['finalizer_star_destroyer.alo']
galactic_back.dds	Unused?	[]
galaxy_map.tga	Unused?	[]
gozanti_b.dds	Unused?	[]
gozanti_empire.dds	Unused?	[]
gozanti_l.dds	Unused?	[]
gun_muzzle_flash_red.dds	Mod	['ev_atar.alo']
hammerhead_corvette.dds	Unused?	[]
hammerhead_corvette_b.dds	Unused?	[]
hammerhead_corvette_l.dds	Unused?	[]
hangar.tga	Unused?	[]
homeone.dds	Unused?	[]
hovercontecho.dds	Unused?	[]
hovercontecho_b.dds	Unused?	[]
hull_2.dds	Unused?	[]
hull_2_b.dds	Unused?	[]
hull_2_sd.dds	Unused?	[]
hull_kitbash_pieces_isd_lights.dds	Unused?	[]
imperator_sd.dds	Mod	['tector.alo']
imperator_sd_b.dds	Mod	['tector.alo']
imperial-class_star_destroyer.dds	Mod	['imperial_i-class_star_destroyer.alo']
imperial-class_star_destroyer_bridge.dds	Mod	['imperial_i-class_star_destroyer.alo']
imperial-class_star_destroyer_bridge_normal.dds	Mod	['imperial_i-class_star_destroyer.alo']
imperial-class_star_destroyer_normal.dds	Mod	['imperial_i-class_star_destroyer.alo']
imperial-class_star_destroyer_thruster_off.dds	Mod	['imperial_i-class_star_destroyer.alo']
imperial-class_star_destroyer_thruster_off_normal.dds	Mod	['imperial_i-class_star_destroyer.alo']
imperial-class_star_destroyer_thruster_on.dds	Mod	['imperial_i-class_star_destroyer.alo']
imperial-class_tect_destroyer.dds	Unused?	[]
imperial-class_tect_destroyer_bridge.dds	Unused?	[]
imperial-class_xyst_destroyer.dds	Unused?	[]
imperial-himer_star_destroyer.dds	Unused?	[]
imperial_clonetrooper_body.dds	Mod	['ei_imperial_clonetrooper.alo']
imperial_clonetrooper_hands.dds	Unused?	[]
imperial_clonetrooper_helmet.dds	Mod	['ei_imperial_clonetrooper.alo']
imperial_e_11_rifle_highres.dds	Mod	['imperial_hero_x1.alo']
imperial_ii-class_star_destroyer.dds	Unused?	[]
imperial_ii-class_star_destroyer_black.dds	Unused?	[]
imperial_ii-class_star_destroyer_black_normal.dds	Unused?	[]
imperial_ii-class_star_destroyer_bridge.dds	Unused?	[]
imperial_ii-class_star_destroyer_bridge_black.dds	Unused?	[]
imperial_ii-class_star_destroyer_bridge_black_normal.dds	Unused?	[]
imperial_ii-class_star_destroyer_bridge_normal.dds	Unused?	[]
imperial_ii-class_star_destroyer_normal.dds	Unused?	[]
imperial_officer_pistol.dds	Mod	['ei_ubrick_adelhard.alo']
impgunner_body_diffuse.dds	Unused?	[]
impgunner_body_normal.dds	Unused?	[]
impgunner_head_diffuse.dds	Unused?	[]
impgunner_head_normal.dds	Unused?	[]
imp_carrack_cruiser.dds	Unused?	[]
imp_carrack_cruiser_b.dds	Unused?	[]
imp_inf_trooper_pack.dds	Mod	['ei_shocktrooper.alo']
imp_inf_trooper_pack_b.dds	Mod	['ei_shocktrooper.alo']
imp_lightcruiser.dds	Mod	['imp_light_cruiser.alo']
imp_officer_adelhard_face.dds	Mod	['ei_ubrick_adelhard.alo']
imp_officer_adelhard_uniform.dds	Mod	['ei_ubrick_adelhard.alo']
imp_officer_drommel_face.dds	Unused?	[]
imp_officer_drommel_uniform.dds	Mod	['ei_ubrick_adelhard.alo']
imp_officer_gray_1_hat.dds	Unused?	[]
imp_quasar_arvistatjik.dds	Mod	['ev_quasar.alo']
imp_quasar_arvistatjik_b.dds	Mod	['ev_quasar.alo']
ir_dreadnaught-cl.dds	Unused?	[]
i_attack_mode.dds	Unused?	[]
i_attack_mode_choice.dds	Unused?	[]
i_bombardment_black_sun.dds	Unused?	[]
i_bombardment_cis_remnant.dds	Unused?	[]
i_bombardment_commerce_guild.dds	Unused?	[]
i_bombardment_corporate_sector.dds	Unused?	[]
i_bombardment_crimson_dawn.dds	Unused?	[]
i_bombardment_early _empire.dds	Unused?	[]
i_bombardment_empire.dds	Unused?	[]
i_bombardment_first_order.dds	Unused?	[]
i_bombardment_hapan_consortium.dds	Unused?	[]
i_bombardment_hutt_cartel.dds	Unused?	[]
i_bombardment_imperial_remnant.dds	Unused?	[]
i_bombardment_imperial_remnant_adelhard.dds	Unused?	[]
i_bombardment_imperial_remnant_gratloe.dds	Unused?	[]
i_bombardment_imperial_remnant_loring.dds	Unused?	[]
i_bombardment_imperial_remnant_rax.dds	Unused?	[]
i_bombardment_imperial_remnant_thrawn.dds	Unused?	[]
i_bombardment_mandalorians.dds	Unused?	[]
i_bombardment_new_republic.dds	Unused?	[]
i_bombardment_pyke_syndicate.dds	Unused?	[]
i_bombardment_rebel.dds	Unused?	[]
i_bombardment_techno_union.dds	Unused?	[]
i_bombardment_terrorists.dds	Unused?	[]
i_bombardment_trade_federation.dds	Unused?	[]
i_button_blank.tga	Mod	['planetary_mode.alo', 'planetary_mode_overlay.alo']
i_fade_edge.dds	Mod	['planetary_mode.alo', 'planetary_mode_overlay.alo']
i_fade_edge.tga	Vanilla	[]
i_galactic_dashboard_skirmish_under.dds	Mod	['i_tactical_controls.alo']
i_galactic_dashboard_wide.dds	Mod	['i_galactic_controls.alo']
i_galactic_organize.dds	Mod	['i_galactic_organize.alo']
i_galactic_organize_land.dds	Mod	['i_galactic_organize.alo']
i_highlight_banking_clan_hero.tga	Unused?	[]
i_highlight_cis_remnant_hero.tga	Unused?	[]
i_highlight_commerce_guild_hero.tga	Unused?	[]
i_highlight_early_empire_hero.tga	Unused?	[]
i_highlight_mandalorians_hero.tga	Unused?	[]
i_highlight_techno_union_hero.tga	Unused?	[]
i_highlight_terrorists_hero.tga	Unused?	[]
i_highlight_trade_federation_hero.tga	Unused?	[]
i_main_hero_frame_empire.dds	Unused?	[]
i_main_hero_frame_rebel.dds	Unused?	[]
i_selection_banking_clan.dds	Unused?	[]
i_selection_black_sun.dds	Unused?	[]
i_selection_cis_remnant.dds	Unused?	[]
i_selection_commerce_guild.dds	Unused?	[]
i_selection_corporate_sector.dds	Unused?	[]
i_selection_crimson_dawn.dds	Unused?	[]
i_selection_early_empire.dds	Unused?	[]
i_selection_empire.dds	Unused?	[]
i_selection_first_order.dds	Unused?	[]
i_selection_hapan_consortium.dds	Unused?	[]
i_selection_hutt_cartel.dds	Unused?	[]
i_selection_imperial_remnant.dds	Unused?	[]
i_selection_imperial_remnant_adelhard.dds	Unused?	[]
i_selection_imperial_remnant_gratloe.dds	Unused?	[]
i_selection_imperial_remnant_loring.dds	Unused?	[]
i_selection_imperial_remnant_rax.dds	Unused?	[]
i_selection_imperial_remnant_thrawn.dds	Unused?	[]
i_selection_mandalorians.dds	Unused?	[]
i_selection_new_republic.dds	Unused?	[]
i_selection_pyke_syndicate.dds	Unused?	[]
i_selection_rebel.dds	Unused?	[]
i_selection_rebel_terrorists.dds	Unused?	[]
i_selection_techno_union.dds	Unused?	[]
i_selection_trade_federation.dds	Unused?	[]
kdy_lights.dds	Mod	['empire_star_destroyeri.alo', 'ev_isd1.alo', 'ev_mandatoriii_aculeus.alo']
liberator.dds	Unused?	[]
lightning_default.dds	Unused?	[]
lights_block_red_lowrez.dds	Unused?	[]
lights_grid_mintgreen_lowrez.dds	Unused?	[]
lights_grid_orange_desaturated_dense.dds	Mod	['empire_starbase_level_01.alo', 'empire_starbase_level_02.alo', 'empire_starbase_level_03.alo', 'empire_starbase_level_04.alo', 'empire_starbase_level_05.alo']
loadmenuback.dds	Unused?	[]
lucrehulkbb.dds	Unused?	[]
m434_blaster.dds	Mod	['ni_duro.alo', 'ni_duro_2.alo', 'ni_selkath.alo']
majestic.dds	Unused?	[]
majestic_b.dds	Unused?	[]
mandator3_engines.dds	Mod	['ev_mandatoriii_aculeus.alo']
mando_backpack_b.dds	Mod	['mi_death_watch_commander.alo', 'm_i_mando_soldier.alo']
mando_backpack_d.dds	Mod	['mi_death_watch_commander.alo', 'm_i_mando_soldier.alo']
mando_blaster_b.dds	Mod	['m_i_mando_soldier.alo']
mando_blaster_d.dds	Mod	['m_i_mando_soldier.alo']
mando_body_b.dds	Mod	['m_i_mando_soldier.alo']
mando_body_d.dds	Mod	['m_i_mando_soldier.alo']
mando_display_d.dds	Mod	['m_i_mando_soldier.alo']
mando_gear_b.dds	Mod	['m_i_mando_soldier.alo']
mando_gear_d.dds	Mod	['m_i_mando_soldier.alo']
mando_helmet_b.dds	Mod	['m_i_mando_soldier.alo']
mando_helmet_d.dds	Mod	['m_i_mando_soldier.alo']
mando_tape_d.dds	Mod	['m_i_mando_soldier.alo']
mc-60.dds	Unused?	[]
mc50.dds	Unused?	[]
mc75.dds	Unused?	[]
mc80c.dds	Unused?	[]
mc90.dds	Unused?	[]
mc90_2.dds	Unused?	[]
mc_40.dds	Unused?	[]
mc_40_b.dds	Unused?	[]
mc_80.dds	Unused?	[]
menuback_overlay.dds	Unused?	[]
menuback_overlay_german_french.dds	Unused?	[]
mi_commando_backpack.dds	Mod	['mi_supercommando_captain.alo']
mi_death_watch_blaster.dds	Mod	['mi_death_watch_lieutenant.alo']
mi_death_watch_blaster_n.dds	Mod	['mi_death_watch_lieutenant.alo']
mi_death_watch_commander.dds	Mod	['mi_death_watch_commander.alo']
mi_death_watch_commander_head.dds	Mod	['mi_death_watch_commander.alo']
mi_death_watch_commander_head_n.dds	Mod	['mi_death_watch_commander.alo']
mi_death_watch_commander_n.dds	Mod	['mi_death_watch_commander.alo']
mi_death_watch_lieutenant.dds	Mod	['mi_death_watch_lieutenant.alo']
mi_death_watch_lieutenant_helmet.dds	Mod	['mi_death_watch_lieutenant.alo']
mi_death_watch_lieutenant_helmet_n.dds	Mod	['mi_death_watch_lieutenant.alo']
mi_death_watch_lieutenant_jetpack.dds	Mod	['mi_death_watch_lieutenant.alo']
mi_death_watch_lieutenant_jetpack_n.dds	Mod	['mi_death_watch_lieutenant.alo']
mi_death_watch_lieutenant_n.dds	Mod	['mi_death_watch_lieutenant.alo']
mi_ee3.dds	Mod	['mi_death_watch_commander.alo']
mi_ee3_n.dds	Mod	['mi_death_watch_commander.alo']
mi_rocket_trooper.dds	Mod	['mi_deathwatch_light.alo', 'mi_rocket_trooper.alo']
mi_rocket_trooper_helmet.dds	Mod	['mi_deathwatch_light.alo', 'mi_rocket_trooper.alo']
mi_rocket_trooper_helmet_n.dds	Mod	['mi_deathwatch_light.alo', 'mi_rocket_trooper.alo']
mi_rocket_trooper_n.dds	Mod	['mi_deathwatch_light.alo', 'mi_rocket_trooper.alo']
mi_supercommandocaptain.dds	Mod	['mi_supercommando_captain.alo']
mi_supercommandocaptain_helmet.dds	Mod	['mi_supercommando_captain.alo']
mi_supercommandocaptain_helmet_n.dds	Mod	['mi_supercommando_captain.alo']
mi_supercommandocaptain_n.dds	Mod	['mi_supercommando_captain.alo']
mothma_basic_hand.dds	Unused?	[]
mothma_boots_hips.dds	Mod	['ri_mon_mothma.alo']
mothma_dress.dds	Mod	['ri_mon_mothma.alo']
mothma_face.dds	Mod	['ri_mon_mothma.alo']
mothma_head.dds	Mod	['ri_mon_mothma.alo']
mothma_l_hand.dds	Mod	['ri_mon_mothma.alo']
mothma_mouth_eyes.dds	Mod	['ri_mon_mothma.alo']
mt_commandbar.mtd	Unused?	[]
mt_commandbar.tga	Unused?	[]
munificent.dds	Mod	['munificent.alo']
m_dc15.dds	Mod	['mi_supercommando_captain.alo']
m_dc15_n.dds	Mod	['mi_supercommando_captain.alo']
m_snipertrooper_a.dds	Mod	['m_snipertrooper.alo']
m_snipertrooper_a_nm.dds	Mod	['m_snipertrooper.alo']
m_snipertrooper_b.dds	Mod	['m_snipertrooper.alo']
m_snipertrooper_b_nm.dds	Mod	['m_snipertrooper.alo']
m_snipertrooper_c.dds	Mod	['m_snipertrooper.alo']
m_snipertrooper_c_nm.dds	Mod	['m_snipertrooper.alo']
m_snipertrooper_d.dds	Mod	['m_snipertrooper.alo']
m_snipertrooper_d_nm.dds	Mod	['m_snipertrooper.alo']
m_snipertrooper_gun.dds	Mod	['m_snipertrooper.alo']
m_snipertrooper_gun_nm.dds	Mod	['m_snipertrooper.alo']
m_snipertrooper_hand.dds	Mod	['m_snipertrooper.alo']
nb_i_deathwatch_blaster.dds	Mod	['m_i_mando_soldier.alo']
nb_i_deathwatch_blaster_b.dds	Mod	['m_i_mando_soldier.alo']
nb_shieldbase_blue.dds	Unused?	[]
nb_shieldripple.dds	Mod	['imperial_i-class_star_destroyer.alo', 't2-b.alo']
nb_shieldwave.dds	Mod	['imperial_i-class_star_destroyer.alo', 't2-b.alo']
nebula-class_star_destroyer_thruster_off.dds	Unused?	[]
nebula-class_star_destroyer_thruster_on.dds	Unused?	[]
nebulon_b_frigate.dds	Unused?	[]
nebulon_b_frigate_b.dds	Unused?	[]
ni_battledroid_head_junker.dds	Unused?	[]
ni_battledroid_head_junker_n.dds	Unused?	[]
ni_duro.dds	Mod	['ni_duro.alo']
ni_duro_2.dds	Mod	['ni_duro_2.alo']
ni_ithorian.dds	Mod	['ni_ithorian.alo']
ni_ithorian_2.dds	Mod	['ni_ithorian_2.alo']
ni_ithorian_3.dds	Mod	['ni_ithorian_3.alo']
ni_ithorian_4.dds	Mod	['ni_ithorian_4.alo']
ni_saw_gerrera.dds	Mod	['ni_saw_gerrera.alo']
ni_saw_gerrera_gun.dds	Mod	['ni_saw_gerrera.alo']
ni_saw_gerrera_head.dds	Mod	['ni_saw_gerrera.alo']
ni_selkath.dds	Mod	['ni_selkath.alo']
nw_se14c.dds	Mod	['mi_deathwatch_light.alo']
nw_se14c_n.dds	Mod	['mi_deathwatch_light.alo']
profundity.dds	Unused?	[]
profundity_b.dds	Unused?	[]
profundity_l.dds	Unused?	[]
providence.dds	Unused?	[]
p_allied_banking_clan.tga	Mod	['p_allied_banking_clan.alo']
p_allied_cis_remnant.tga	Mod	['p_allied_cis_remnant.alo']
p_allied_commerce_guild.tga	Unused?	[]
p_allied_early_empire.tga	Mod	['p_allied_early_empire.alo']
p_allied_mandalorians.tga	Unused?	[]
p_allied_techno_union.tga	Unused?	[]
p_allied_terrorists.tga	Mod	['p_allied_terrorists.alo']
p_allied_trade_federation.tga	Mod	['p_allied_trade_federation.alo']
p_nebula_ambient.dds	Mod	['p_nebula.alo']
p_nebula_cloud.dds	Unused?	[]
p_nebula_cloud02.dds	Unused?	[]
p_nebula_lightning.dds	Unused?	[]
p_particle_explosion01.dds	Mod	['p_bomber_hit_large.alo', 'p_damage_bomber_ground_green.alo', 'p_damage_bomber_ground_red.alo', 'p_damage_ground_large_blue.alo', 'p_damage_ground_large_green.alo', 'p_damage_ground_large_ion.alo', 'p_damage_ground_large_purple.alo', 'p_damage_ground_large_red.alo', 'p_damage_ground_large_yellow.alo', 'p_explosion_hardpoint_small.alo']
p_particle_explosion02.dds	Mod	['p_bomber_hit_large.alo', 'p_explosion_hardpoint_small.alo']
p_particle_explosion03.dds	Mod	['p_damage_ground_large_blue.alo', 'p_damage_ground_large_green.alo', 'p_damage_ground_large_ion.alo', 'p_damage_ground_large_purple.alo', 'p_damage_ground_large_red.alo', 'p_damage_ground_large_yellow.alo', 'p_damage_ground_medium_blue.alo', 'p_damage_ground_medium_green.alo', 'p_damage_ground_medium_ion.alo', 'p_damage_ground_medium_purple.alo', 'p_damage_ground_medium_red.alo', 'p_damage_ground_medium_yellow.alo', 'p_damage_ground_small_blue.alo', 'p_damage_ground_small_green.alo', 'p_damage_ground_small_ion.alo', 'p_damage_ground_small_purple.alo', 'p_damage_ground_small_red.alo', 'p_damage_ground_small_yellow.alo', 'p_damage_turbolaser_medium.alo', 'p_damage_turbolaser_small.alo', 'p_explosion_hardpoint_small.alo']
p_particle_explosions.dds	Mod	['p_damage_turbolaser_ion_medium.alo', 'p_damage_turbolaser_ion_small.alo', 'p_damage_turbolaser_medium.alo', 'p_damage_turbolaser_small.alo', 'p_explosion_capital.alo', 'p_explosion_corvette.alo', 'p_explosion_hardpoint.alo', 'p_explosion_hardpoint_small.alo', 'p_explosion_hardpoint_starbase.alo', 'p_explosion_station.alo']
p_particle_explosions01.dds	Mod	['p_damage_bomber_ground_green.alo', 'p_damage_bomber_ground_red.alo', 'p_damage_ground_large_blue.alo', 'p_damage_ground_large_green.alo', 'p_damage_ground_large_ion.alo', 'p_damage_ground_large_purple.alo', 'p_damage_ground_large_red.alo', 'p_damage_ground_large_yellow.alo', 'p_damage_ground_medium_blue.alo', 'p_damage_ground_medium_green.alo', 'p_damage_ground_medium_ion.alo', 'p_damage_ground_medium_purple.alo', 'p_damage_ground_medium_red.alo', 'p_damage_ground_medium_yellow.alo', 'p_damage_ground_small_blue.alo', 'p_damage_ground_small_green.alo', 'p_damage_ground_small_ion.alo', 'p_damage_ground_small_purple.alo', 'p_damage_ground_small_red.alo', 'p_damage_ground_small_yellow.alo', 'p_damage_turbolaser_ion_medium.alo', 'p_damage_turbolaser_ion_small.alo', 'p_damage_turbolaser_small.alo', 'p_explosion_capital.alo', 'p_explosion_corvette.alo', 'p_explosion_cruiser.alo', 'p_explosion_hardpoint.alo', 'p_explosion_hardpoint_small.alo', 'p_explosion_hardpoint_starbase.alo']
p_particle_flash.dds	Mod	['p_bomber_hit_large.alo', 'p_damage_bomber_ground_green.alo', 'p_damage_bomber_ground_red.alo', 'p_damage_ground_large_blue.alo', 'p_damage_ground_large_green.alo', 'p_damage_ground_large_ion.alo', 'p_damage_ground_large_purple.alo', 'p_damage_ground_large_red.alo', 'p_damage_ground_large_yellow.alo', 'p_damage_ground_medium_blue.alo', 'p_damage_ground_medium_green.alo', 'p_damage_ground_medium_ion.alo', 'p_damage_ground_medium_purple.alo', 'p_damage_ground_medium_red.alo', 'p_damage_ground_medium_yellow.alo', 'p_damage_ground_small_blue.alo', 'p_damage_ground_small_green.alo', 'p_damage_ground_small_ion.alo', 'p_damage_ground_small_purple.alo', 'p_damage_ground_small_red.alo', 'p_damage_ground_small_yellow.alo', 'p_damage_turbolaser_blue_large.alo', 'p_damage_turbolaser_blue_medium.alo', 'p_damage_turbolaser_blue_small.alo', 'p_damage_turbolaser_green_large.alo', 'p_damage_turbolaser_green_medium.alo', 'p_damage_turbolaser_green_small.alo', 'p_damage_turbolaser_ion_medium.alo', 'p_damage_turbolaser_ion_small.alo', 'p_damage_turbolaser_medium.alo', 'p_damage_turbolaser_purple_large.alo', 'p_damage_turbolaser_purple_medium.alo', 'p_damage_turbolaser_purple_small.alo', 'p_damage_turbolaser_red_large.alo', 'p_damage_turbolaser_red_medium.alo', 'p_damage_turbolaser_red_small.alo', 'p_damage_turbolaser_small.alo', 'p_damage_turbolaser_yellow_large.alo', 'p_damage_turbolaser_yellow_medium.alo', 'p_damage_turbolaser_yellow_small.alo', 'p_explosion_capital.alo', 'p_explosion_corvette.alo', 'p_explosion_cruiser.alo', 'p_explosion_hardpoint.alo', 'p_explosion_hardpoint_small.alo', 'p_explosion_hardpoint_starbase.alo', 'p_explosion_station.alo', 'p_infantry_blaster_b.alo', 'p_infantry_blaster_g.alo', 'p_infantry_blaster_i.alo', 'p_infantry_blaster_p.alo', 'p_infantry_blaster_r.alo', 'p_infantry_blaster_y.alo']
p_particle_hit_explosion.dds	Mod	['p_bomber_hit_large.alo', 'p_damage_bomber_ground_green.alo', 'p_damage_bomber_ground_red.alo', 'p_damage_ground_large_blue.alo', 'p_damage_ground_large_green.alo', 'p_damage_ground_large_ion.alo', 'p_damage_ground_large_purple.alo', 'p_damage_ground_large_red.alo', 'p_damage_ground_large_yellow.alo', 'p_damage_ground_medium_blue.alo', 'p_damage_ground_medium_green.alo', 'p_damage_ground_medium_ion.alo', 'p_damage_ground_medium_purple.alo', 'p_damage_ground_medium_red.alo', 'p_damage_ground_medium_yellow.alo', 'p_damage_turbolaser_medium.alo', 'p_explosion_station.alo', 'p_shield_hit_large.alo']
p_particle_light.dds	Mod	['pe_imperial_star_destroyer_large.alo', 'pp_concussion_missile_b.alo']
p_particle_smoke.dds	Mod	['p_bomber_hit_large.alo', 'p_damage_bomber_ground_green.alo', 'p_damage_bomber_ground_red.alo', 'p_damage_turbolaser_blue_large.alo', 'p_damage_turbolaser_blue_medium.alo', 'p_damage_turbolaser_blue_small.alo', 'p_damage_turbolaser_green_large.alo', 'p_damage_turbolaser_green_medium.alo', 'p_damage_turbolaser_green_small.alo', 'p_damage_turbolaser_purple_large.alo', 'p_damage_turbolaser_purple_medium.alo', 'p_damage_turbolaser_purple_small.alo', 'p_damage_turbolaser_red_large.alo', 'p_damage_turbolaser_red_medium.alo', 'p_damage_turbolaser_red_small.alo', 'p_damage_turbolaser_small.alo', 'p_damage_turbolaser_yellow_large.alo', 'p_damage_turbolaser_yellow_medium.alo', 'p_damage_turbolaser_yellow_small.alo', 'p_explosion_capital.alo', 'p_explosion_corvette.alo', 'p_explosion_cruiser.alo', 'p_explosion_hardpoint.alo', 'p_explosion_hardpoint_small.alo', 'p_explosion_hardpoint_starbase.alo', 'p_infantry_blaster_b.alo', 'p_infantry_blaster_g.alo', 'p_infantry_blaster_i.alo', 'p_infantry_blaster_p.alo', 'p_infantry_blaster_r.alo', 'p_infantry_blaster_y.alo']
p_turbolaser_infantry.dds	Mod	['w_proj_infantry_y.alo']
p_turbolaser_space.dds	Unused?	[]
p_turbolaser_vehicle.dds	Unused?	[]
raider_corvette.dds	Unused?	[]
raider_corvette_b.dds	Unused?	[]
raider_corvette_l.dds	Unused?	[]
ra_gargantuan.dds	Unused?	[]
rebelguerillaa_c.dds	Mod	['ri_rebel_sniper_urban.alo']
rebelguerillaa_n.dds	Mod	['ri_commando.alo', 'ri_rebel_sniper_urban.alo']
rebelguerillab_c.dds	Mod	['ri_commando.alo', 'ri_grenadier.alo']
rebelguerillab_n.dds	Mod	['ri_commando.alo', 'ri_grenadier.alo']
rebelguerillac_c.dds	Unused?	[]
rebelguerillac_n.dds	Unused?	[]
rebelpilot_body_diff.dds	Mod	['ri_pilot.alo']
rebelpilot_body_norm.dds	Mod	['ri_pilot.alo']
rebelpilot_head_diff.dds	Mod	['ri_pilot.alo']
rebelpilot_head_norm.dds	Mod	['ri_pilot.alo']
rebelsaboteur_diffb.dds	Mod	['ri_saboteur.alo']
rebelsaboteur_normb.dds	Mod	['ri_saboteur.alo']
rebelsnipereye_c.dds	Mod	['ri_rebel_sniper_snow.alo', 'ri_rebel_sniper_urban.alo']
rebelsniperhead_c.dds	Mod	['ri_rebel_sniper_snow.alo', 'ri_rebel_sniper_urban.alo']
rebelsniperhead_n.dds	Mod	['ri_rebel_sniper_snow.alo', 'ri_rebel_sniper_urban.alo']
rebelsniperskin_c.dds	Mod	['ri_rebel_sniper_urban.alo']
rebeltrooperhoth_body_bump.dds	Mod	['ri_stormtrooper.alo']
rebeltrooperhoth_body_diff.dds	Mod	['ri_stormtrooper.alo']
rebeltrooper_head_bump.dds	Mod	['ri_stormtrooper.alo']
rebeltrooper_head_diffuse.dds	Mod	['ri_stormtrooper.alo']
reb_a_wing.dds	Unused?	[]
reb_a_wing_e.dds	Unused?	[]
reb_a_wing_n.dds	Unused?	[]
reb_b_wing.dds	Unused?	[]
reb_b_wing_n.dds	Unused?	[]
reb_pelta.dds	Unused?	[]
reb_pelta_b.dds	Unused?	[]
reb_pelta_l.dds	Unused?	[]
reb_quasar_arvistatjik_l.dds	Mod	['ev_quasar.alo']
reb_uwing_standard.dds	Unused?	[]
reb_uwing_standard_n.dds	Unused?	[]
reb_x_wing.dds	Unused?	[]
reb_x_wing_e.dds	Unused?	[]
reb_x_wing_n.dds	Unused?	[]
reb_y_wing.dds	Unused?	[]
reb_y_wing_e.dds	Unused?	[]
reb_y_wing_n.dds	Unused?	[]
recusant.dds	Mod	['cis_recusant_frigate.alo']
redflash.dds	Mod	['ei_shocktrooper_heavy.alo', 'mi_deathwatch_light.alo', 'mi_death_watch_commander.alo', 'm_snipertrooper.alo', 'ri_grenadier.alo', 'ri_stormtrooper.alo']
rep_battledroid_arms_r2d2.dds	Unused?	[]
rep_battledroid_arms_r2d2_n.dds	Unused?	[]
rep_battledroid_arms_training.dds	Unused?	[]
rep_battledroid_arms_training_n.dds	Unused?	[]
rep_battledroid_head_r2d2.dds	Unused?	[]
rep_battledroid_head_r2d2_n.dds	Unused?	[]
rep_battledroid_head_training.dds	Unused?	[]
rep_battledroid_head_training_n.dds	Unused?	[]
rep_battledroid_legs_r2d2.dds	Unused?	[]
rep_battledroid_legs_r2d2_n.dds	Unused?	[]
rep_battledroid_legs_training.dds	Unused?	[]
rep_battledroid_legs_training_n.dds	Unused?	[]
rep_battledroid_oom_arms_r2d2.dds	Unused?	[]
rep_battledroid_oom_arms_r2d2_n.dds	Unused?	[]
rep_battledroid_oom_head_r2d2.dds	Unused?	[]
rep_battledroid_oom_head_r2d2_n.dds	Unused?	[]
rep_battledroid_oom_legs_r2d2.dds	Unused?	[]
rep_battledroid_oom_legs_r2d2_n.dds	Unused?	[]
rep_battledroid_pack_r2d2.dds	Unused?	[]
rep_battledroid_pack_training.dds	Unused?	[]
rep_battledroid_pack_training_n.dds	Unused?	[]
rep_clonetrooper_bodysuit.dds	Mod	['ei_purgetrooper_commander.alo']
rep_clonetrooper_bodysuit_n.dds	Mod	['ei_purgetrooper_commander.alo']
rep_clone_dc15.dds	Mod	['ei_purgetrooper_commander.alo', 'rep_clonetrooper_p2_heavy.alo']
rep_clone_dc15_n.dds	Mod	['ei_purgetrooper_commander.alo', 'rep_clonetrooper_p2_heavy.alo']
rep_clone_handsbasic.dds	Mod	['501st_clonetrooper.alo', 'ei_imperial_clonetrooper.alo', 'rep_arctrooper_p2.alo', 'rep_clonetrooper_p2_basic.alo', 'rep_clonetrooper_p2_heavy.alo']
rep_clone_handsbasic_b.dds	Mod	['501st_clonetrooper.alo', 'ei_imperial_clonetrooper.alo', 'rep_arctrooper_p2.alo', 'rep_clonetrooper_p2_basic.alo', 'rep_clonetrooper_p2_heavy.alo']
rep_clone_phase1_arc_gear_blue.dds	Mod	['rep_arctrooper_p2.alo']
rep_clone_phase1_arc_parts_blue.dds	Mod	['rep_arctrooper_p2.alo']
rep_clone_phase1_arc_parts_blue_b.dds	Mod	['rep_arctrooper_p2.alo']
rep_clone_phase1_arc_torso_blue.dds	Mod	['rep_arctrooper_p2.alo']
rep_clone_phase1_arc_torso_blue_b.dds	Mod	['rep_arctrooper_p2.alo']
rep_clone_phase1_helm.dds	Unused?	[]
rep_clone_phase1_helm_b.dds	Unused?	[]
rep_clone_phase2_arc_helmet_blue.dds	Mod	['rep_arctrooper_p2.alo']
rep_clone_phase2_arc_helmet_blue_n.dds	Mod	['rep_arctrooper_p2.alo']
rep_clone_phase2_arc_pack.dds	Mod	['rep_arctrooper_p2.alo']
rep_clone_phase2_arc_pack_b.dds	Mod	['rep_arctrooper_p2.alo']
rep_clone_phase2_arc_plate_blue.dds	Mod	['rep_arctrooper_p2.alo']
rep_clone_phase2_arc_plate_blue_b.dds	Mod	['rep_arctrooper_p2.alo']
rep_clone_phase2_helmbacara.dds	Mod	['rep_clonetrooper_p2_heavy.alo']
rep_clone_phase2_helmbacaratrim.dds	Mod	['rep_clonetrooper_p2_heavy.alo']
rep_clone_phase2_helmbacaratrim_b.dds	Mod	['rep_clonetrooper_p2_heavy.alo']
rep_clone_phase2_helmbacara_top.dds	Mod	['rep_clonetrooper_p2_heavy.alo']
rep_clone_phase2_helmbacara_top_b.dds	Mod	['rep_clonetrooper_p2_heavy.alo']
rep_clone_phase2_helmbasic.dds	Mod	['rep_clonetrooper_p2_basic.alo']
rep_clone_phase2_helmbasic_b.dds	Mod	['ei_imperial_clonetrooper.alo', 'rep_clonetrooper_p2_basic.alo', 'rep_clonetrooper_p2_heavy.alo']
rep_clone_phase2_helmblue.dds	Mod	['501st_clonetrooper.alo']
rep_clone_phase2_helmblue_b.dds	Mod	['501st_clonetrooper.alo']
rep_clone_phase2_helmvisorantenna.dds	Mod	['rep_clonetrooper_p2_heavy.alo']
rep_clone_phase2_helmvisorantenna_b.dds	Mod	['rep_clonetrooper_p2_heavy.alo']
rep_clone_phase2_kilt501st.dds	Mod	['rep_arctrooper_p2.alo']
rep_clone_phase2_kilt501st_b.dds	Mod	['rep_arctrooper_p2.alo', 'rep_clonetrooper_p2_heavy.alo']
rep_clone_phase2_kilt_snow.dds	Mod	['rep_clonetrooper_p2_heavy.alo']
rep_clone_phase2_parts327_b.dds	Unused?	[]
rep_clone_phase2_pauldron327_b.dds	Mod	['rep_arctrooper_p2.alo']
rep_clone_phase2_torsobasic.dds	Mod	['501st_clonetrooper.alo', 'rep_clonetrooper_p2_basic.alo', 'rep_clonetrooper_p2_heavy.alo']
rep_clone_phase2_torsobasic_b.dds	Mod	['501st_clonetrooper.alo', 'ei_imperial_clonetrooper.alo', 'rep_clonetrooper_p2_basic.alo', 'rep_clonetrooper_p2_heavy.alo']
rep_clone_phase2_torsoblue.dds	Mod	['501st_clonetrooper.alo']
rep_clone_phase2_torsoblue_b.dds	Mod	['501st_clonetrooper.alo']
rep_clone_phase2_vaughn_parts.dds	Unused?	[]
rep_commando_accessories.dds	Mod	['rep_commando.alo']
rep_commando_accessories_n.dds	Mod	['rep_commando.alo']
rep_commando_backpack.dds	Mod	['rep_commando.alo']
rep_commando_backpack_n.dds	Mod	['rep_commando.alo']
rep_commando_hands.dds	Mod	['rep_commando.alo']
rep_commando_helmet.dds	Mod	['rep_commando.alo']
rep_commando_helmet_n.dds	Mod	['rep_commando.alo']
rep_commando_legs.dds	Mod	['rep_commando.alo']
rep_commando_legs_n.dds	Mod	['rep_commando.alo']
rep_commando_torso.dds	Mod	['rep_commando.alo']
rep_commando_torso_n.dds	Mod	['rep_commando.alo']
rep_commando_visor.dds	Mod	['rep_commando.alo']
rep_dc15a.dds	Mod	['501st_clonetrooper.alo', 'ei_imperial_clonetrooper.alo', 'rep_arctrooper_p2.alo', 'rep_clonetrooper_p2_basic.alo']
rep_dc15a_n.dds	Mod	['501st_clonetrooper.alo', 'ei_imperial_clonetrooper.alo', 'rep_arctrooper_p2.alo', 'rep_clonetrooper_p2_basic.alo']
rep_dc15c.dds	Mod	['ri_light_elite.alo']
rep_dc15c_n.dds	Mod	['ri_light_elite.alo']
rep_lightcruiser.dds	Unused?	[]
rep_lightcruiser_b.dds	Mod	['imp_light_cruiser.alo']
rep_lightcruiser_l.dds	Mod	['imp_light_cruiser.alo']
rep_plex_launcher.dds	Mod	['mi_rocket_trooper.alo']
rep_plex_launcher_b.dds	Mod	['mi_rocket_trooper.alo']
rep_starbase.dds	Unused?	[]
rep_starbase_b.dds	Unused?	[]
rep_starbase_lights.dds	Unused?	[]
resi_battledroid_arms.dds	Mod	['resi_b1_battledroid.alo']
resi_battledroid_arms_n.dds	Mod	['resi_b1_battledroid.alo']
resi_battledroid_head.dds	Mod	['resi_b1_battledroid.alo']
resi_battledroid_head_n.dds	Mod	['resi_b1_battledroid.alo']
resi_battledroid_legs.dds	Mod	['resi_b1_battledroid.alo']
resi_battledroid_legs_n.dds	Mod	['resi_b1_battledroid.alo']
resi_battledroid_pack.dds	Mod	['resi_b1_battledroid.alo']
resi_battledroid_pack_n.dds	Mod	['resi_b1_battledroid.alo']
rev_atpt.dds	Unused?	[]
rev_atpt_b.dds	Unused?	[]
ri_a180_c.dds	Unused?	[]
ri_a180_n.dds	Unused?	[]
ri_a280.dds	Mod	['ri_commando.alo', 'ri_grenadier.alo']
ri_a280cfe_c.dds	Unused?	[]
ri_a280cfe_n.dds	Unused?	[]
ri_a280_n.dds	Mod	['ri_commando.alo', 'ri_grenadier.alo']
ri_cassian_head.dds	Unused?	[]
ri_cassian_head_n.dds	Unused?	[]
ri_cassian_legs.dds	Unused?	[]
ri_cassian_legs_n.dds	Unused?	[]
ri_commando.dds	Mod	['ri_commando.alo']
ri_commando_amor.dds	Mod	['ri_commando.alo']
ri_commando_amor_n.dds	Mod	['ri_commando.alo']
ri_commando_backpack.dds	Mod	['mi_deathwatch_light.alo', 'ri_commando.alo']
ri_commando_backpack_n.dds	Mod	['mi_deathwatch_light.alo', 'mi_supercommando_captain.alo', 'ri_commando.alo']
ri_commando_mask.dds	Mod	['ri_commando.alo']
ri_commando_n.dds	Mod	['ri_commando.alo']
ri_commando_v2.dds	Unused?	[]
ri_elite_diffuse.dds	Mod	['ri_light_elite.alo']
ri_elite_norm.dds	Mod	['ri_light_elite.alo']
ri_guard_trooper_body.dds	Mod	['rebel_guard_trooper.alo']
ri_guard_trooper_helmet.dds	Mod	['rebel_guard_trooper.alo']
ri_hh12.dds	Mod	['ri_trooper_plex_forest.alo', 'ri_trooper_plex_sand.alo', 'ri_trooper_plex_snow.alo', 'ri_trooper_plex_urban.alo']
ri_hh12_n.dds	Mod	['ri_trooper_plex_forest.alo', 'ri_trooper_plex_sand.alo', 'ri_trooper_plex_snow.alo', 'ri_trooper_plex_urban.alo']
ri_jyn_erso_body.dds	Unused?	[]
ri_jyn_erso_body_n.dds	Unused?	[]
ri_jyn_erso_head.dds	Unused?	[]
ri_jyn_erso_head_n.dds	Unused?	[]
ri_jyn_erso_scarf.dds	Unused?	[]
ri_jyn_erso_scarf_n.dds	Unused?	[]
ri_kyle_katarn_mouth_eyes.dds	Mod	['ei_armytrooper.alo']
ri_luke_body.dds	Mod	['ri_skywalker.alo']
ri_luke_body_n.dds	Mod	['ri_skywalker.alo']
ri_luke_gloves.dds	Mod	['ri_skywalker.alo']
ri_luke_gloves_n.dds	Mod	['ri_skywalker.alo']
ri_luke_hair.dds	Mod	['ri_skywalker.alo']
ri_luke_haircap.dds	Mod	['ri_skywalker.alo']
ri_luke_head.dds	Mod	['ri_skywalker.alo']
ri_luke_head_n.dds	Mod	['ri_skywalker.alo']
ri_luke_saber.dds	Mod	['ri_skywalker.alo']
ri_luke_saber_glow.dds	Mod	['ri_skywalker.alo']
ri_luke_saber_n.dds	Mod	['ri_skywalker.alo']
ri_luke_vest.dds	Mod	['ri_skywalker.alo']
ri_luke_vest_n.dds	Mod	['ri_skywalker.alo']
ri_rebelforest_backpack.dds	Mod	['ri_grenadier.alo']
ri_rebelforest_backpack_n.dds	Mod	['ri_grenadier.alo']
ri_rebelgrenadier.dds	Mod	['ri_grenadier.alo']
ri_rebelgrenadier_glass.dds	Mod	['ri_grenadier.alo']
ri_rebelgrenadier_n.dds	Mod	['ri_grenadier.alo']
ri_rebelsnipersand_body_c.dds	Mod	['ri_rebel_sniper_urban.alo']
ri_rebelsnipersand_body_n.dds	Mod	['ri_rebel_sniper_urban.alo']
ri_rebelsnipersand_helmet_c.dds	Mod	['ri_commando.alo', 'ri_rebel_sniper_urban.alo']
ri_rebelsnipersand_helmet_n.dds	Mod	['ri_commando.alo', 'ri_rebel_sniper_urban.alo']
ri_rebelsnipersnow_backpack_c.dds	Mod	['ri_rebel_sniper_snow.alo']
ri_rebelsnipersnow_backpack_n.dds	Mod	['ri_rebel_sniper_snow.alo']
ri_rebelsnipersnow_body_c.dds	Mod	['ri_rebel_sniper_snow.alo']
ri_rebelsnipersnow_body_n.dds	Mod	['ri_rebel_sniper_snow.alo']
ri_rebelsnipersnow_glove_c.dds	Mod	['ri_rebel_sniper_snow.alo']
ri_rebelsnipersnow_glove_n.dds	Mod	['ri_rebel_sniper_snow.alo']
ri_rebelsnipersnow_helmet_c.dds	Mod	['ri_rebel_sniper_snow.alo']
ri_rebelsnipersnow_helmet_n.dds	Mod	['ri_rebel_sniper_snow.alo']
ri_rebelsniper_backpack_c.dds	Mod	['ri_rebel_sniper_urban.alo']
ri_rebelsniper_backpack_n.dds	Mod	['ri_rebel_sniper_urban.alo']
ri_rebelsniper_body_c.dds	Mod	['ri_rebel_sniper_urban.alo']
ri_rebelsniper_body_n.dds	Mod	['ri_rebel_sniper_urban.alo']
ri_rebelsniper_hands_c.dds	Mod	['ri_commando.alo', 'ri_rebel_sniper_urban.alo']
ri_rebelsniper_hands_n.dds	Mod	['ri_rebel_sniper_urban.alo']
ri_rebelsniper_helmet_c.dds	Unused?	[]
ri_rebelsniper_helmet_n.dds	Unused?	[]
ri_sabinewren_01.dds	Unused?	[]
ri_sabinewren_01_n.dds	Unused?	[]
ri_sabinewren_02.dds	Unused?	[]
ri_sabinewren_02_n.dds	Unused?	[]
ri_sabinewren_wp.dds	Unused?	[]
ri_sabinewren_wp_n.dds	Unused?	[]
ri_skywalker.dds	Mod	['anakin_skywalker_dark.alo']
ri_stormtrooper_body.dds	Mod	['ri_stormtrooper_v3.alo']
ri_trooper_a280.dds	Mod	['rebel_guard_trooper.alo', 'ri_trooper_forest_human.alo', 'ri_trooper_snow_human.alo', 'ri_trooper_snow_twilek.alo', 'ri_trooper_urban_human.alo', 'ri_trooper_urban_rodian.alo', 'ri_trooper_urban_twilek.alo']
ri_trooper_a280c.dds	Mod	['ri_trooper_sand_human3.alo', 'ri_trooper_snow_human3.alo', 'ri_trooper_urban_ishitib3.alo', 'ri_trooper_urban_mirialan.alo', 'ri_trooper_urban_quarren3.alo', 'ri_trooper_urban_rodian3.alo']
ri_trooper_a280cfe.dds	Mod	['ri_stormtrooper_v3.alo', 'ri_trooper_forest_twilek.alo', 'ri_trooper_sand_twilek.alo', 'ri_trooper_urban_aqualish.alo', 'ri_trooper_urban_female2.alo', 'ri_trooper_urban_quarren2.alo', 'ri_trooper_urban_rodian2.alo']
ri_trooper_a280cfe_n.dds	Mod	['ri_stormtrooper_v3.alo', 'ri_trooper_forest_twilek.alo', 'ri_trooper_sand_twilek.alo', 'ri_trooper_urban_aqualish.alo', 'ri_trooper_urban_female2.alo', 'ri_trooper_urban_quarren2.alo', 'ri_trooper_urban_rodian2.alo']
ri_trooper_a280c_n.dds	Mod	['ri_trooper_sand_human3.alo', 'ri_trooper_snow_human3.alo', 'ri_trooper_urban_ishitib3.alo', 'ri_trooper_urban_mirialan.alo', 'ri_trooper_urban_quarren3.alo', 'ri_trooper_urban_rodian3.alo']
ri_trooper_a280_n.dds	Mod	['rebel_guard_trooper.alo', 'ri_trooper_forest_human.alo', 'ri_trooper_snow_human.alo', 'ri_trooper_snow_twilek.alo', 'ri_trooper_urban_human.alo', 'ri_trooper_urban_rodian.alo', 'ri_trooper_urban_twilek.alo']
ri_trooper_anton.dds	Mod	['rebel_guard_trooper.alo', 'ri_trooper_forest_human.alo', 'ri_trooper_plex_forest.alo', 'ri_trooper_plex_sand.alo', 'ri_trooper_plex_urban.alo', 'ri_trooper_sand_human3.alo', 'ri_trooper_snow_human.alo', 'ri_trooper_snow_human3.alo', 'ri_trooper_urban_human.alo']
ri_trooper_anton_n.dds	Mod	['rebel_guard_trooper.alo', 'ri_trooper_forest_human.alo', 'ri_trooper_plex_forest.alo', 'ri_trooper_plex_sand.alo', 'ri_trooper_plex_urban.alo', 'ri_trooper_sand_human3.alo', 'ri_trooper_snow_human.alo', 'ri_trooper_snow_human3.alo', 'ri_trooper_urban_human.alo']
ri_trooper_aqualish.dds	Mod	['ri_trooper_urban_aqualish.alo']
ri_trooper_aqualish_eyes.dds	Mod	['ri_trooper_urban_aqualish.alo']
ri_trooper_aqualish_n.dds	Mod	['ri_trooper_urban_aqualish.alo']
ri_trooper_eyes.dds	Mod	['rebel_guard_trooper.alo', 'ri_skywalker.alo', 'ri_trooper_forest_human.alo', 'ri_trooper_plex_forest.alo', 'ri_trooper_plex_sand.alo', 'ri_trooper_plex_urban.alo', 'ri_trooper_sand_human3.alo', 'ri_trooper_snow_human.alo', 'ri_trooper_snow_human3.alo', 'ri_trooper_urban_human.alo']
ri_trooper_female_eyes.dds	Mod	['ri_trooper_forest_twilek.alo', 'ri_trooper_sand_twilek.alo', 'ri_trooper_snow_twilek.alo', 'ri_trooper_urban_female2.alo', 'ri_trooper_urban_mirialan.alo', 'ri_trooper_urban_twilek.alo']
ri_trooper_female_hair.dds	Mod	['ri_trooper_urban_female2.alo']
ri_trooper_forest_backpack.dds	Mod	['ri_trooper_forest_human.alo', 'ri_trooper_plex_forest.alo']
ri_trooper_forest_backpack_n.dds	Mod	['ri_trooper_forest_human.alo', 'ri_trooper_plex_forest.alo']
ri_trooper_forest_body.dds	Mod	['ri_trooper_plex_forest.alo']
ri_trooper_forest_body_n.dds	Mod	['ri_trooper_plex_forest.alo']
ri_trooper_forest_female_backpack.dds	Mod	['ri_trooper_forest_twilek.alo', 'ri_trooper_sand_twilek.alo']
ri_trooper_forest_female_backpack_n.dds	Mod	['ri_trooper_forest_twilek.alo', 'ri_trooper_sand_twilek.alo']
ri_trooper_forest_female_body.dds	Mod	['ri_trooper_forest_twilek.alo']
ri_trooper_forest_female_body_n.dds	Mod	['ri_trooper_forest_twilek.alo']
ri_trooper_forest_hands.dds	Mod	['ri_trooper_forest_human.alo', 'ri_trooper_forest_twilek.alo', 'ri_trooper_plex_forest.alo', 'ri_trooper_plex_sand.alo', 'ri_trooper_sand_human3.alo']
ri_trooper_forest_hands_n.dds	Mod	['ri_trooper_forest_human.alo', 'ri_trooper_forest_twilek.alo', 'ri_trooper_plex_forest.alo', 'ri_trooper_plex_sand.alo', 'ri_trooper_sand_human3.alo']
ri_trooper_forest_helmet.dds	Mod	['ri_trooper_forest_human.alo', 'ri_trooper_plex_forest.alo']
ri_trooper_forest_helmet_n.dds	Mod	['ri_trooper_forest_human.alo', 'ri_trooper_plex_forest.alo']
ri_trooper_forest_legs.dds	Mod	['ri_trooper_forest_human.alo']
ri_trooper_forest_legs_n.dds	Mod	['ri_trooper_forest_human.alo']
ri_trooper_forest_torso.dds	Mod	['ri_trooper_forest_human.alo']
ri_trooper_forest_torso_n.dds	Mod	['ri_trooper_forest_human.alo']
ri_trooper_heavy_sand_legs.dds	Mod	['ri_trooper_sand_human3.alo']
ri_trooper_heavy_sand_legs_n.dds	Mod	['ri_trooper_sand_human3.alo']
ri_trooper_heavy_sand_torso.dds	Mod	['ri_trooper_sand_human3.alo']
ri_trooper_heavy_sand_torso_n.dds	Mod	['ri_trooper_sand_human3.alo']
ri_trooper_heavy_urban_backpack.dds	Mod	['ri_stormtrooper_v3.alo', 'ri_trooper_sand_human3.alo', 'ri_trooper_urban_ishitib3.alo', 'ri_trooper_urban_quarren3.alo', 'ri_trooper_urban_rodian3.alo']
ri_trooper_heavy_urban_backpack_n.dds	Mod	['ri_stormtrooper_v3.alo', 'ri_trooper_sand_human3.alo', 'ri_trooper_urban_ishitib3.alo', 'ri_trooper_urban_quarren3.alo', 'ri_trooper_urban_rodian3.alo']
ri_trooper_heavy_urban_body.dds	Mod	['ri_trooper_urban_ishitib3.alo', 'ri_trooper_urban_quarren3.alo', 'ri_trooper_urban_rodian3.alo']
ri_trooper_heavy_urban_body_n.dds	Mod	['ri_trooper_urban_ishitib3.alo', 'ri_trooper_urban_quarren3.alo', 'ri_trooper_urban_rodian3.alo']
ri_trooper_heavy_urban_legs.dds	Mod	['ri_trooper_urban_ishitib3.alo', 'ri_trooper_urban_quarren3.alo', 'ri_trooper_urban_rodian3.alo']
ri_trooper_heavy_urban_legs_n.dds	Mod	['ri_trooper_urban_ishitib3.alo', 'ri_trooper_urban_quarren3.alo', 'ri_trooper_urban_rodian3.alo']
ri_trooper_heavy_urban_parts.dds	Mod	['ri_trooper_sand_human3.alo', 'ri_trooper_urban_ishitib3.alo', 'ri_trooper_urban_quarren3.alo', 'ri_trooper_urban_rodian3.alo']
ri_trooper_heavy_urban_parts_n.dds	Mod	['ri_trooper_sand_human3.alo', 'ri_trooper_urban_ishitib3.alo', 'ri_trooper_urban_quarren3.alo', 'ri_trooper_urban_rodian3.alo']
ri_trooper_ishitib.dds	Mod	['ri_trooper_urban_ishitib3.alo']
ri_trooper_ishitib_hands.dds	Mod	['ri_trooper_urban_ishitib3.alo']
ri_trooper_ishitib_hands_n.dds	Mod	['ri_trooper_urban_ishitib3.alo']
ri_trooper_ishitib_n.dds	Mod	['ri_trooper_urban_ishitib3.alo']
ri_trooper_kristin.dds	Mod	['ri_trooper_urban_female2.alo']
ri_trooper_kristin_n.dds	Mod	['ri_trooper_urban_female2.alo']
ri_trooper_mirialan.dds	Mod	['ri_trooper_urban_mirialan.alo']
ri_trooper_mirialan_n.dds	Mod	['ri_trooper_urban_mirialan.alo']
ri_trooper_quarren.dds	Mod	['ri_trooper_urban_quarren2.alo', 'ri_trooper_urban_quarren3.alo']
ri_trooper_quarren_hands.dds	Mod	['ri_trooper_urban_quarren2.alo', 'ri_trooper_urban_quarren3.alo']
ri_trooper_quarren_hands_n.dds	Mod	['ri_trooper_urban_quarren2.alo', 'ri_trooper_urban_quarren3.alo']
ri_trooper_quarren_n.dds	Mod	['ri_trooper_urban_quarren2.alo', 'ri_trooper_urban_quarren3.alo']
ri_trooper_rodian.dds	Mod	['ri_trooper_urban_rodian.alo', 'ri_trooper_urban_rodian2.alo', 'ri_trooper_urban_rodian3.alo']
ri_trooper_rodian_eyes.dds	Mod	['ri_trooper_urban_rodian.alo', 'ri_trooper_urban_rodian2.alo', 'ri_trooper_urban_rodian3.alo']
ri_trooper_rodian_n.dds	Mod	['ri_trooper_urban_rodian.alo', 'ri_trooper_urban_rodian2.alo', 'ri_trooper_urban_rodian3.alo']
ri_trooper_sand_backpack.dds	Mod	['ri_trooper_plex_sand.alo']
ri_trooper_sand_backpack_n.dds	Mod	['ri_trooper_plex_sand.alo']
ri_trooper_sand_body.dds	Mod	['ri_trooper_plex_sand.alo']
ri_trooper_sand_body_n.dds	Mod	['ri_trooper_plex_sand.alo']
ri_trooper_sand_female_backpack.dds	Unused?	[]
ri_trooper_sand_female_backpack_n.dds	Unused?	[]
ri_trooper_sand_female_body.dds	Mod	['ri_trooper_sand_twilek.alo']
ri_trooper_sand_female_body_n.dds	Mod	['ri_trooper_sand_twilek.alo']
ri_trooper_sand_helmet.dds	Mod	['ri_trooper_plex_sand.alo', 'ri_trooper_sand_human3.alo']
ri_trooper_sand_helmet_n.dds	Mod	['ri_trooper_plex_sand.alo', 'ri_trooper_sand_human3.alo']
ri_trooper_sand_legs.dds	Unused?	[]
ri_trooper_sand_legs_n.dds	Unused?	[]
ri_trooper_sand_torso.dds	Unused?	[]
ri_trooper_sand_torso_n.dds	Unused?	[]
ri_trooper_snow_backpack.dds	Mod	['ri_trooper_plex_snow.alo', 'ri_trooper_snow_human.alo', 'ri_trooper_snow_human3.alo']
ri_trooper_snow_backpack_n.dds	Mod	['ri_trooper_plex_snow.alo', 'ri_trooper_snow_human.alo', 'ri_trooper_snow_human3.alo']
ri_trooper_snow_female_backpack.dds	Mod	['ri_trooper_snow_twilek.alo']
ri_trooper_snow_female_backpack_n.dds	Mod	['ri_trooper_snow_twilek.alo']
ri_trooper_snow_female_hat.dds	Unused?	[]
ri_trooper_snow_female_hat_n.dds	Unused?	[]
ri_trooper_snow_female_legs.dds	Mod	['ri_trooper_snow_twilek.alo']
ri_trooper_snow_female_legs_n.dds	Mod	['ri_trooper_snow_twilek.alo']
ri_trooper_snow_gloves.dds	Mod	['ri_trooper_plex_snow.alo', 'ri_trooper_snow_human.alo', 'ri_trooper_snow_human3.alo', 'ri_trooper_snow_twilek.alo']
ri_trooper_snow_gloves_n.dds	Mod	['ri_trooper_plex_snow.alo', 'ri_trooper_snow_human.alo', 'ri_trooper_snow_human3.alo', 'ri_trooper_snow_twilek.alo']
ri_trooper_snow_hat.dds	Mod	['ri_trooper_snow_human.alo', 'ri_trooper_snow_human3.alo']
ri_trooper_snow_hat_n.dds	Mod	['ri_trooper_snow_human.alo', 'ri_trooper_snow_human3.alo']
ri_trooper_snow_head.dds	Mod	['ri_trooper_plex_snow.alo']
ri_trooper_snow_head_n.dds	Mod	['ri_trooper_plex_snow.alo']
ri_trooper_snow_legs.dds	Mod	['ri_trooper_plex_snow.alo', 'ri_trooper_snow_human.alo', 'ri_trooper_snow_human3.alo']
ri_trooper_snow_legs_n.dds	Mod	['ri_trooper_plex_snow.alo', 'ri_trooper_snow_human.alo', 'ri_trooper_snow_human3.alo']
ri_trooper_snow_torso.dds	Mod	['ri_trooper_plex_snow.alo', 'ri_trooper_snow_human.alo', 'ri_trooper_snow_human3.alo', 'ri_trooper_snow_twilek.alo']
ri_trooper_snow_torso_n.dds	Mod	['ri_trooper_plex_snow.alo', 'ri_trooper_snow_human.alo', 'ri_trooper_snow_human3.alo', 'ri_trooper_snow_twilek.alo']
ri_trooper_twilek.dds	Mod	['ri_trooper_forest_twilek.alo', 'ri_trooper_sand_twilek.alo', 'ri_trooper_snow_twilek.alo', 'ri_trooper_urban_twilek.alo']
ri_trooper_twilek_face.dds	Mod	['ri_trooper_forest_twilek.alo', 'ri_trooper_sand_twilek.alo', 'ri_trooper_snow_twilek.alo', 'ri_trooper_urban_twilek.alo']
ri_trooper_twilek_face_n.dds	Mod	['ri_trooper_forest_twilek.alo', 'ri_trooper_sand_twilek.alo', 'ri_trooper_snow_twilek.alo', 'ri_trooper_urban_twilek.alo']
ri_trooper_twilek_n.dds	Mod	['ri_trooper_forest_twilek.alo', 'ri_trooper_sand_twilek.alo', 'ri_trooper_snow_twilek.alo', 'ri_trooper_urban_twilek.alo']
ri_trooper_urban_backpack.dds	Mod	['ri_trooper_urban_quarren2.alo', 'ri_trooper_urban_rodian2.alo']
ri_trooper_urban_backpack2.dds	Mod	['ri_trooper_urban_aqualish.alo', 'ri_trooper_urban_female2.alo', 'ri_trooper_urban_mirialan.alo', 'ri_trooper_urban_twilek.alo']
ri_trooper_urban_backpack2_n.dds	Mod	['ri_trooper_urban_aqualish.alo', 'ri_trooper_urban_female2.alo', 'ri_trooper_urban_mirialan.alo', 'ri_trooper_urban_twilek.alo']
ri_trooper_urban_backpack_n.dds	Mod	['ri_trooper_urban_quarren2.alo', 'ri_trooper_urban_rodian2.alo']
ri_trooper_urban_body.dds	Mod	['ri_trooper_plex_urban.alo', 'ri_trooper_urban_human.alo', 'ri_trooper_urban_quarren2.alo', 'ri_trooper_urban_rodian.alo', 'ri_trooper_urban_rodian2.alo']
ri_trooper_urban_body_n.dds	Mod	['rebel_guard_trooper.alo', 'ri_trooper_plex_urban.alo', 'ri_trooper_urban_human.alo', 'ri_trooper_urban_quarren2.alo', 'ri_trooper_urban_rodian.alo', 'ri_trooper_urban_rodian2.alo']
ri_trooper_urban_female_body.dds	Mod	['ri_trooper_urban_aqualish.alo', 'ri_trooper_urban_female2.alo', 'ri_trooper_urban_mirialan.alo', 'ri_trooper_urban_twilek.alo']
ri_trooper_urban_female_body_n.dds	Mod	['ri_trooper_urban_aqualish.alo', 'ri_trooper_urban_female2.alo', 'ri_trooper_urban_mirialan.alo', 'ri_trooper_urban_twilek.alo']
ri_trooper_urban_female_gloves.dds	Mod	['ri_trooper_urban_female2.alo']
ri_trooper_urban_female_gloves_brown.dds	Mod	['ri_trooper_sand_twilek.alo', 'ri_trooper_urban_aqualish.alo', 'ri_trooper_urban_mirialan.alo', 'ri_trooper_urban_twilek.alo']
ri_trooper_urban_female_gloves_brown_n.dds	Mod	['ri_trooper_sand_twilek.alo', 'ri_trooper_urban_aqualish.alo', 'ri_trooper_urban_mirialan.alo', 'ri_trooper_urban_twilek.alo']
ri_trooper_urban_female_gloves_n.dds	Mod	['ri_trooper_urban_female2.alo']
ri_trooper_urban_female_hat.dds	Mod	['ri_trooper_urban_female2.alo', 'ri_trooper_urban_mirialan.alo']
ri_trooper_urban_female_hat_n.dds	Mod	['ri_trooper_urban_female2.alo', 'ri_trooper_urban_mirialan.alo']
ri_trooper_urban_female_legs.dds	Mod	['ri_trooper_urban_aqualish.alo', 'ri_trooper_urban_female2.alo', 'ri_trooper_urban_mirialan.alo', 'ri_trooper_urban_twilek.alo']
ri_trooper_urban_female_legs_n.dds	Mod	['ri_trooper_urban_aqualish.alo', 'ri_trooper_urban_female2.alo', 'ri_trooper_urban_mirialan.alo', 'ri_trooper_urban_twilek.alo']
ri_trooper_urban_gloves.dds	Mod	['rebel_guard_trooper.alo', 'ri_trooper_plex_urban.alo', 'ri_trooper_urban_human.alo', 'ri_trooper_urban_rodian.alo', 'ri_trooper_urban_rodian2.alo', 'ri_trooper_urban_rodian3.alo']
ri_trooper_urban_gloves_n.dds	Mod	['rebel_guard_trooper.alo', 'ri_trooper_plex_urban.alo', 'ri_trooper_urban_human.alo', 'ri_trooper_urban_rodian.alo', 'ri_trooper_urban_rodian2.alo', 'ri_trooper_urban_rodian3.alo']
ri_trooper_urban_helmet.dds	Mod	['ri_trooper_plex_urban.alo', 'ri_trooper_urban_human.alo']
ri_trooper_urban_helmet_n.dds	Mod	['rebel_guard_trooper.alo', 'ri_trooper_plex_urban.alo', 'ri_trooper_urban_human.alo']
ri_trooper_urban_strap.dds	Mod	['rebel_guard_trooper.alo', 'ri_trooper_urban_human.alo']
ri_trooper_urban_strap_n.dds	Mod	['rebel_guard_trooper.alo', 'ri_trooper_urban_human.alo']
rv_aac_hovertank bump.dds	Unused?	[]
rv_aac_hovertank.dds	Unused?	[]
rv_new_snowspeeder.dds	Mod	['rv_snowspeeder.alo']
rv_new_snowspeeder_b.dds	Mod	['rv_snowspeeder.alo']
rv_t1bx.dds	Unused?	[]
rv_t1bx_b.dds	Unused?	[]
sandtrooper_head_diffuse_opt.dds	Mod	['ei_shocktrooper.alo', 'ei_trooper_sand.alo', 'ev_at_dt.alo']
scouttrooperbody.dds	Unused?	[]
scouttrooperbody_nm.dds	Mod	['ev_bike.alo']
scouttrooperbody_rgb512.dds	Mod	['ev_bike.alo']
scouttrooperhead.dds	Mod	['ev_bike.alo']
scouttrooper_head_nm.dds	Mod	['ev_bike.alo']
se14r.dds	Unused?	[]
se14r_scope.dds	Unused?	[]
silver_square.dds	Mod	['ri_dyn_jarren_the_mandalorian.alo']
space_starkillerbase_a_01_diffuse.dds	Unused?	[]
splash.dds	Unused?	[]
splash_french.dds	Unused?	[]
splash_german.dds	Unused?	[]
splash_german.png	Unused?	[]
splash_italian.dds	Unused?	[]
splash_polish.dds	Unused?	[]
splash_russian.dds	Unused?	[]
splash_spanish.dds	Unused?	[]
splash_uk.dds	Unused?	[]
stormtrooper_body_normal_opt.dds	Mod	['ei_magmatrooper.alo', 'ei_shocktrooper.alo', 'ei_trooper.alo', 'ei_trooper_sand.alo', 'ev_at_dt.alo']
stormtrooper_head_diffuse_opt.dds	Mod	['ei_magmatrooper.alo', 'ei_trooper.alo']
stormtrooper_remnant_redpauldren.dds	Unused?	[]
sulfur.dds	Unused?	[]
sulfur_bc.dds	Unused?	[]
thruster.dds	Unused?	[]
tradeline.dds	Unused?	[]
uv_balrus.dds	Unused?	[]
uv_balrus_b.dds	Unused?	[]
venator-class_star_destroyer.dds	Unused?	[]
venator-class_star_destroyer_normal.dds	Unused?	[]
victory1.dds	Unused?	[]
victory1_hull.dds	Unused?	[]
victory1_hull_normal.dds	Unused?	[]
victory1_normal.dds	Unused?	[]
victoryi.dds	Unused?	[]
victoryii.dds	Unused?	[]
victoryii_b.dds	Unused?	[]
victoryi_b.dds	Unused?	[]
viscount.dds	Unused?	[]
viscount_b.dds	Unused?	[]
viscount_l.dds	Unused?	[]
vsd1.dds	Unused?	[]
vsd1_normal.dds	Unused?	[]
w_asteroid.dds	Unused?	[]
w_blackholegcring.dds	Unused?	[]
w_blackholegcring01.dds	Unused?	[]
w_blackholegcring02.dds	Unused?	[]
w_blackhole_rings1.png	Unused?	[]
w_blackhole_rings1_gc.png	Unused?	[]
w_blackhole_rings2.png	Unused?	[]
w_blackhole_rings2_gc.png	Unused?	[]
w_blackhole_rings3.png	Unused?	[]
w_blackhole_rings3_gc.png	Unused?	[]
w_blueflash.dds	Unused?	[]
w_cloudsgc_desert.dds	Mod	['w_planetgc_desert.alo']
w_cloudsgc_desert01.dds	Unused?	[]
w_cloudsgc_desert01_b.dds	Unused?	[]
w_cloudsgc_desert_b.dds	Mod	['w_planetgc_desert.alo']
w_cloudsgc_forest.dds	Mod	['w_planetgc_forest.alo']
w_cloudsgc_forest01.dds	Unused?	[]
w_cloudsgc_forest01_b.dds	Unused?	[]
w_cloudsgc_forest_b.dds	Mod	['w_planetgc_forest.alo']
w_cloudsgc_ice.dds	Mod	['w_planetgc_ice.alo']
w_cloudsgc_ice01.dds	Unused?	[]
w_cloudsgc_ice01_b.dds	Unused?	[]
w_cloudsgc_ice_b.dds	Mod	['w_planetgc_ice.alo']
w_cloudsgc_ocean.dds	Mod	['w_planetgc_ocean.alo']
w_cloudsgc_ocean_b.dds	Mod	['w_planetgc_ocean.alo']
w_cloudsgc_swamp.dds	Mod	['w_planetgc_swamp.alo']
w_cloudsgc_swamp01.dds	Unused?	[]
w_cloudsgc_swamp01_b.dds	Mod	['w_planetgc_swamp.alo']
w_cloudsgc_swamp_b.dds	Unused?	[]
w_cloudsgc_temperate.dds	Mod	['w_planetgc_temperate.alo']
w_cloudsgc_temperate01.dds	Mod	['w_planetgc_yavin4.alo']
w_cloudsgc_temperate01_b.dds	Mod	['w_planetgc_temperate.alo', 'w_planetgc_yavin4.alo']
w_cloudsgc_temperate_b.dds	Unused?	[]
w_cloudsgc_urban.dds	Mod	['w_planetgc_urban.alo']
w_cloudsgc_urban01.dds	Unused?	[]
w_cloudsgc_urban01_b.dds	Unused?	[]
w_cloudsgc_urban_b.dds	Mod	['w_planetgc_urban.alo']
w_cloudsgc_volcanic.dds	Mod	['w_planetgc_volcanic.alo']
w_cloudsgc_volcanic01.dds	Unused?	[]
w_cloudsgc_volcanic01_b.dds	Unused?	[]
w_cloudsgc_volcanic_b.dds	Mod	['w_planetgc_volcanic.alo']
w_galaxy.dds	Unused?	[]
w_galaxy_dot.dds	Unused?	[]
w_galaxy_rote.dds	Unused?	[]
w_galaxy_select.dds	Mod	['w_planet_select.alo', 'w_planet_select_empire.alo', 'w_planet_select_neutral.alo', 'w_planet_select_pirate.alo', 'w_planet_select_rebel.alo']
w_galaxy_skydome.dds	Unused?	[]
w_galaxy_starfield.dds	Mod	['w_galaxy00.alo']
w_gal_gradient.tga	Mod	['w_galaxy00.alo']
w_gal_grid.dds	Mod	['i_galactic_controls.alo', 'w_galaxy00.alo']
w_gal_grid_disp.dds	Mod	['w_galaxy00.alo']
w_gal_grid_wave.dds	Mod	['w_galaxy00.alo']
w_gal_line.dds	Unused?	[]
w_gal_line.tga	Unused?	[]
w_hole.tga	Unused?	[]
w_laser_full.dds	Mod	['ri_stormtrooper_v3.alo', 'ri_trooper_forest_human.alo', 'ri_trooper_forest_twilek.alo', 'ri_trooper_sand_human3.alo', 'ri_trooper_sand_twilek.alo', 'ri_trooper_snow_human.alo', 'ri_trooper_snow_human3.alo', 'ri_trooper_snow_twilek.alo', 'ri_trooper_urban_aqualish.alo', 'ri_trooper_urban_female2.alo', 'ri_trooper_urban_human.alo', 'ri_trooper_urban_ishitib3.alo', 'ri_trooper_urban_mirialan.alo', 'ri_trooper_urban_quarren2.alo', 'ri_trooper_urban_quarren3.alo', 'ri_trooper_urban_rodian.alo', 'ri_trooper_urban_rodian2.alo', 'ri_trooper_urban_rodian3.alo', 'ri_trooper_urban_twilek.alo']
w_laser_red.dds	Mod	['cis_b1_battledroid.alo', 'cis_b1_battledroid_geo_heavy.alo', 'cis_b1_battledroid_grenadier.alo', 'cis_b1_battledroid_heavy.alo', 'cis_b1_battledroid_oom_pistol.alo', 'cis_b1_battledroid_specialist.alo', 'cis_b1_commander_oom.alo', 'cis_b1_heavy.alo', 'cis_b1_heavy_geo.alo', 'cis_b1_specialist.alo', 'cis_b2droid.alo', 'cis_b2_ha _battledroid.alo', 'cis_bx_commando.alo', 'cis_bx_commando_captain.alo', 'ei_deathtrooper.alo', 'ei_magmatrooper.alo', 'ei_mudtrooper.alo', 'ei_mustafartrooper.alo', 'ei_novatrooper.alo', 'ei_shocktrooper_heavy.alo', 'ei_shoretrooper.alo', 'ei_thrawn.alo', 'ei_trooper_sand.alo', 'ei_trooper_snow.alo', 'ei_vader.alo', 'mi_deathwatch_light.alo', 'mi_death_watch_commander.alo', 'resi_b1_battledroid.alo', 'ri_grenadier.alo', 'ri_trooper_plex_forest.alo', 'ri_trooper_plex_sand.alo', 'ri_trooper_plex_snow.alo', 'ri_trooper_plex_urban.alo']
w_laser_sma11.dds	Mod	['ei_imperial_super_commando.alo']
w_laser_smal2.dds	Unused?	[]
w_laser_small_blue.dds	Mod	['anakin_skywalker_dark.alo', 'ei_purgetrooper_commander.alo', 'mi_death_watch_lieutenant.alo', 'mi_supercommando_captain.alo', 'rep_arctrooper_p2.alo', 'rep_clonetrooper_p2_basic.alo', 'rep_clonetrooper_p2_heavy.alo', 'ri_light_elite.alo', 'ri_rebel_sniper_snow.alo']
w_laser_small_silver.dds	Mod	['ri_rebel_jedi_ahsoka_tano.alo']
w_nebula03.dds	Mod	['w_skydome_nebula_pirpleblue.alo']
w_nebulaskirmish_exogol.dds	Mod	['w_skydome_nebula_exogol.alo']
w_nebulaskirmish_pirpleblue.dds	Unused?	[]
w_nebula_blue.dds	Unused?	[]
w_nebula_brown.dds	Unused?	[]
w_nebula_cyan.dds	Unused?	[]
w_nebula_green.dds	Unused?	[]
w_nebula_purple.dds	Unused?	[]
w_nebula_red.dds	Unused?	[]
w_nebula_wrap.tga	Mod	['w_nebula03.alo']
w_nebula_yellow.dds	Unused?	[]
w_planetclouds_none.dds	Mod (tga)	['w_planet_deathstar02.alo']
w_planetgc_alarisprime_alt0.dds	Mod	['w_planetgc_alarisprime.alo']
w_planetgc_alarisprime_alt0_b.dds	Mod	['w_planetgc_alarisprime.alo']
w_planetgc_alarisprime_alt1.dds	Mod	['w_planetgc_alarisprime.alo']
w_planetgc_alarisprime_alt1_b.dds	Mod	['w_planetgc_alarisprime.alo']
w_planetgc_alarisprime_giant_alt0.dds	Mod	['w_planetgc_alarisprime.alo']
w_planetgc_alarisprime_giant_alt1.dds	Mod	['w_planetgc_alarisprime.alo']
w_planetgc_alderaan_alt0.dds	Mod	['w_planetgc_alderaan.alo']
w_planetgc_alderaan_alt0_b.dds	Mod	['w_planetgc_alderaan.alo']
w_planetgc_alderaan_alt1.dds	Mod	['w_planetgc_alderaan.alo']
w_planetgc_alderaan_alt1_b.dds	Mod	['w_planetgc_alderaan.alo']
w_planetgc_archipelago01_alt0.dds	Mod	['w_planetgc_archipelago01.alo']
w_planetgc_archipelago01_alt0_b.dds	Mod	['w_planetgc_archipelago01.alo']
w_planetgc_archipelago01_alt1.dds	Mod	['w_planetgc_archipelago01.alo']
w_planetgc_archipelago01_alt1_b.dds	Mod	['w_planetgc_archipelago01.alo']
w_planetgc_archipelago01_clouds_alt0.dds	Mod	['spaceprop_mixed01.alo', 'w_planetgc_alderaan.alo', 'w_planetgc_archipelago01.alo', 'w_planetgc_archipelago02.alo', 'w_planetgc_archipelago03.alo', 'w_planetgc_archipelago04.alo']
w_planetgc_archipelago01_clouds_alt0_b.dds	Mod	['spaceprop_mixed01.alo', 'w_planetgc_alderaan.alo', 'w_planetgc_archipelago01.alo', 'w_planetgc_archipelago02.alo', 'w_planetgc_archipelago03.alo', 'w_planetgc_archipelago04.alo']
w_planetgc_archipelago01_clouds_alt1.dds	Mod	['w_planetgc_alderaan.alo', 'w_planetgc_archipelago01.alo', 'w_planetgc_archipelago02.alo', 'w_planetgc_archipelago03.alo', 'w_planetgc_archipelago04.alo']
w_planetgc_archipelago01_clouds_alt1_b.dds	Mod	['w_planetgc_alderaan.alo', 'w_planetgc_archipelago01.alo', 'w_planetgc_archipelago02.alo', 'w_planetgc_archipelago03.alo', 'w_planetgc_archipelago04.alo']
w_planetgc_archipelago02_alt0.dds	Mod	['w_planetgc_archipelago02.alo']
w_planetgc_archipelago02_alt0_b.dds	Mod	['w_planetgc_archipelago02.alo']
w_planetgc_archipelago02_alt1.dds	Mod	['w_planetgc_archipelago02.alo']
w_planetgc_archipelago02_alt1_b.dds	Mod	['w_planetgc_archipelago02.alo']
w_planetgc_archipelago03_alt0.dds	Mod	['w_planetgc_archipelago03.alo']
w_planetgc_archipelago03_alt0_b.dds	Mod	['w_planetgc_archipelago03.alo']
w_planetgc_archipelago03_alt1.dds	Mod	['w_planetgc_archipelago03.alo']
w_planetgc_archipelago03_alt1_b.dds	Mod	['w_planetgc_archipelago03.alo']
w_planetgc_archipelago04_alt0.dds	Mod	['w_planetgc_archipelago04.alo']
w_planetgc_archipelago04_alt0_b.dds	Mod	['w_planetgc_archipelago04.alo']
w_planetgc_archipelago04_alt1.dds	Mod	['w_planetgc_archipelago04.alo']
w_planetgc_archipelago04_alt1_b.dds	Mod	['w_planetgc_archipelago04.alo']
w_planetgc_atmosphere_bespin.dds	Mod	['w_planetgc_bespin.alo']
w_planetgc_atmosphere_blue.dds	Mod	['spaceprop_mixed01.alo', 'w_planetgc_alderaan.alo', 'w_planetgc_archipelago01.alo', 'w_planetgc_archipelago02.alo', 'w_planetgc_archipelago03.alo', 'w_planetgc_archipelago04.alo', 'w_planetgc_forest01.alo', 'w_planetgc_forest02.alo', 'w_planetgc_forest03.alo', 'w_planetgc_forest04.alo', 'w_planetgc_kuat.alo', 'w_planetgc_mixed01.alo', 'w_planetgc_mixed02.alo', 'w_planetgc_mixed03.alo', 'w_planetgc_mixed04.alo', 'w_planetgc_savann01.alo', 'w_planetgc_savann02.alo', 'w_planetgc_savann03.alo', 'w_planetgc_savann04.alo', 'w_planetgc_seatos.alo', 'w_planetgc_steppen01.alo', 'w_planetgc_steppen02.alo', 'w_planetgc_steppen03.alo', 'w_planetgc_steppen04.alo', 'w_planetgc_taiga01.alo', 'w_planetgc_taiga02.alo', 'w_planetgc_taiga03.alo', 'w_planetgc_taiga04.alo', 'w_planetgc_temperate01.alo', 'w_planetgc_temperate02.alo', 'w_planetgc_temperate03.alo', 'w_planetgc_temperate04.alo', 'w_spaceprop_savann01.alo']
w_planetgc_atmosphere_ice01.dds	Mod	['w_planetgc_ice01.alo', 'w_planetgc_ice02.alo', 'w_planetgc_ice03.alo', 'w_planetgc_ice04.alo', 'w_planetgc_kijimi.alo', 'w_planetgc_mountain01.alo', 'w_planetgc_mountain02.alo', 'w_planetgc_mountain03.alo', 'w_planetgc_mountain04.alo', 'w_planetgc_mustafar.alo']
w_planetgc_atmosphere_jungle01.dds	Mod	['w_planetgc_alarisprime.alo', 'w_planetgc_christophsis.alo', 'w_planetgc_jungle01.alo', 'w_planetgc_jungle02.alo', 'w_planetgc_jungle03.alo', 'w_planetgc_jungle04.alo']
w_planetgc_atmosphere_mounttemperate01.dds	Mod	['w_planetgc_coruscant.alo', 'w_planetgc_desert01.alo', 'w_planetgc_desert02.alo', 'w_planetgc_desert03.alo', 'w_planetgc_desert04.alo', 'w_planetgc_endor.alo', 'w_planetgc_mountain_temperate01.alo', 'w_planetgc_mountain_temperate02.alo', 'w_planetgc_mountain_temperate03.alo', 'w_planetgc_mountain_temperate04.alo']
w_planetgc_atmosphere_najedha.dds	Mod	['w_planetgc_jedha.alo']
w_planetgc_atmosphere_red.dds	Mod	['w_planetgc_antar.alo', 'w_planetgc_yavin4.alo']
w_planetgc_atmosphere_swamp01.dds	Mod	['w_planetgc_nallhutta.alo', 'w_planetgc_swamp01.alo', 'w_planetgc_swamp02.alo', 'w_planetgc_swamp03.alo', 'w_planetgc_swamp04.alo']
w_planetgc_atmosphere_tundra01.dds	Mod	['w_planetgc_peridea.alo', 'w_planetgc_tundra01.alo', 'w_planetgc_tundra02.alo', 'w_planetgc_tundra03.alo', 'w_planetgc_tundra04.alo']
w_planetgc_atmosphere_urban01.dds	Mod	['w_planetgc_telos.alo', 'w_planetgc_urban01.alo', 'w_planetgc_urban02.alo', 'w_planetgc_urban03.alo', 'w_planetgc_urban04.alo']
w_planetgc_atmosphere_volcanic01.dds	Mod	['w_planetgc_volcanic01.alo', 'w_planetgc_volcanic02.alo', 'w_planetgc_volcanic03.alo', 'w_planetgc_volcanic04.alo']
w_planetgc_atmosphere_white.dds	Mod	['w_planetgc_exogol.alo']
w_planetgc_bespin_alt0.dds	Mod	['w_planetgc_bespin.alo']
w_planetgc_bespin_alt1.dds	Mod	['w_planetgc_bespin.alo']
w_planetgc_christophsis_alt0.dds	Mod	['w_planetgc_christophsis.alo']
w_planetgc_christophsis_alt0_b.dds	Mod	['w_planetgc_christophsis.alo']
w_planetgc_christophsis_alt1.dds	Mod	['w_planetgc_christophsis.alo']
w_planetgc_christophsis_alt1_b.dds	Mod	['w_planetgc_christophsis.alo']
w_planetgc_christophsis_alt1_l.dds	Mod	['w_planetgc_christophsis.alo']
w_planetgc_coruscant_alt0.dds	Mod	['w_planetgc_coruscant.alo']
w_planetgc_coruscant_alt0_b.dds	Mod	['w_planetgc_coruscant.alo']
w_planetgc_coruscant_alt1.dds	Mod	['w_planetgc_coruscant.alo']
w_planetgc_coruscant_alt1_b.dds	Mod	['w_planetgc_coruscant.alo']
w_planetgc_coruscant_l.dds	Mod	['w_planetgc_coruscant.alo']
w_planetgc_coruscant_l__alt0.dds	Unused?	[]
w_planetgc_desert.dds	Mod	['w_planetgc_desert.alo']
w_planetgc_desert01.dds	Unused?	[]
w_planetgc_desert01_alt0.dds	Mod	['w_planetgc_desert01.alo']
w_planetgc_desert01_alt0_b.dds	Mod	['w_planetgc_desert01.alo']
w_planetgc_desert01_alt1.dds	Mod	['w_planetgc_desert01.alo']
w_planetgc_desert01_alt1_b.dds	Mod	['w_planetgc_desert01.alo']
w_planetgc_desert01_b.dds	Unused?	[]
w_planetgc_desert01_clouds_alt0.dds	Mod	['w_planetgc_desert01.alo', 'w_planetgc_desert02.alo', 'w_planetgc_desert03.alo', 'w_planetgc_desert04.alo', 'w_planetgc_jedha.alo']
w_planetgc_desert01_clouds_alt0_b.dds	Mod	['w_planetgc_jedha.alo']
w_planetgc_desert01_clouds_alt1.dds	Mod	['w_planetgc_desert01.alo', 'w_planetgc_desert02.alo', 'w_planetgc_desert03.alo', 'w_planetgc_desert04.alo', 'w_planetgc_jedha.alo']
w_planetgc_desert01_clouds_alt1_b.dds	Mod	['w_planetgc_desert01.alo', 'w_planetgc_desert02.alo', 'w_planetgc_desert03.alo', 'w_planetgc_desert04.alo', 'w_planetgc_jedha.alo']
w_planetgc_desert02_alt0.dds	Mod	['w_planetgc_desert02.alo']
w_planetgc_desert02_alt0_b.dds	Mod	['w_planetgc_desert02.alo']
w_planetgc_desert02_alt1.dds	Mod	['w_planetgc_desert02.alo']
w_planetgc_desert02_alt1_b.dds	Mod	['w_planetgc_desert02.alo']
w_planetgc_desert03_alt0.dds	Mod	['w_planetgc_desert03.alo']
w_planetgc_desert03_alt0_b.dds	Mod	['w_planetgc_desert03.alo']
w_planetgc_desert03_alt1.dds	Mod	['w_planetgc_desert03.alo']
w_planetgc_desert03_alt1_b.dds	Mod	['w_planetgc_desert03.alo']
w_planetgc_desert04_alt0.dds	Mod	['w_planetgc_desert04.alo']
w_planetgc_desert04_alt0_b.dds	Mod	['w_planetgc_desert04.alo']
w_planetgc_desert04_alt1.dds	Mod	['w_planetgc_desert04.alo']
w_planetgc_desert04_alt1_b.dds	Mod	['w_planetgc_desert04.alo']
w_planetgc_desert_b.dds	Mod	['w_planetgc_desert.alo']
w_planetgc_endor_alt0.dds	Mod	['w_planetgc_endor.alo']
w_planetgc_endor_alt0_b.dds	Mod	['w_planetgc_endor.alo']
w_planetgc_endor_alt1.dds	Mod	['w_planetgc_endor.alo']
w_planetgc_endor_alt1_b.dds	Mod	['w_planetgc_endor.alo']
w_planetgc_endor_gas_alt0.dds	Mod	['w_planetgc_endor.alo']
w_planetgc_endor_gas_alt1.dds	Mod	['w_planetgc_endor.alo']
w_planetgc_exogol_alt0.dds	Mod	['w_planetgc_exogol.alo']
w_planetgc_exogol_alt0_b.dds	Mod	['w_planetgc_exogol.alo']
w_planetgc_exogol_alt1.dds	Mod	['w_planetgc_exogol.alo']
w_planetgc_exogol_alt1_b.dds	Mod	['w_planetgc_exogol.alo']
w_planetgc_exogol_alt1_l.dds	Mod	['w_planetgc_exogol.alo']
w_planetgc_forest.dds	Mod	['w_planetgc_forest.alo']
w_planetgc_forest01.dds	Unused?	[]
w_planetgc_forest01_alt0.dds	Mod	['w_planetgc_forest01.alo']
w_planetgc_forest01_alt0_b.dds	Mod	['w_planetgc_forest01.alo']
w_planetgc_forest01_alt1.dds	Mod	['w_planetgc_forest01.alo']
w_planetgc_forest01_alt1_b.dds	Mod	['w_planetgc_forest01.alo']
w_planetgc_forest01_b.dds	Unused?	[]
w_planetgc_forest01_clouds_alt0.dds	Mod	['w_planetgc_alarisprime.alo', 'w_planetgc_endor.alo', 'w_planetgc_forest01.alo', 'w_planetgc_forest02.alo', 'w_planetgc_forest03.alo', 'w_planetgc_forest04.alo', 'w_planetgc_kuat.alo', 'w_planetgc_mixed01.alo', 'w_planetgc_mixed02.alo', 'w_planetgc_mixed03.alo', 'w_planetgc_mixed04.alo', 'w_planetgc_mustafar.alo']
w_planetgc_forest01_clouds_alt1.dds	Mod	['w_planetgc_alarisprime.alo', 'w_planetgc_endor.alo', 'w_planetgc_forest01.alo', 'w_planetgc_forest02.alo', 'w_planetgc_forest03.alo', 'w_planetgc_forest04.alo', 'w_planetgc_kuat.alo', 'w_planetgc_mixed01.alo', 'w_planetgc_mixed02.alo', 'w_planetgc_mixed03.alo', 'w_planetgc_mixed04.alo', 'w_planetgc_mustafar.alo']
w_planetgc_forest01_clouds_b_alt0.dds	Mod	['w_planetgc_alarisprime.alo', 'w_planetgc_endor.alo', 'w_planetgc_forest01.alo', 'w_planetgc_forest02.alo', 'w_planetgc_forest03.alo', 'w_planetgc_forest04.alo', 'w_planetgc_kuat.alo', 'w_planetgc_mixed01.alo', 'w_planetgc_mixed02.alo', 'w_planetgc_mixed03.alo', 'w_planetgc_mixed04.alo', 'w_planetgc_mustafar.alo']
w_planetgc_forest01_clouds_b_alt1.dds	Mod	['w_planetgc_alarisprime.alo', 'w_planetgc_endor.alo', 'w_planetgc_forest01.alo', 'w_planetgc_forest02.alo', 'w_planetgc_forest03.alo', 'w_planetgc_forest04.alo', 'w_planetgc_kuat.alo', 'w_planetgc_mixed01.alo', 'w_planetgc_mixed02.alo', 'w_planetgc_mixed03.alo', 'w_planetgc_mixed04.alo', 'w_planetgc_mustafar.alo']
w_planetgc_forest02_alt0.dds	Mod	['w_planetgc_forest02.alo']
w_planetgc_forest02_alt0_b.dds	Mod	['w_planetgc_forest02.alo']
w_planetgc_forest02_alt1.dds	Mod	['w_planetgc_forest02.alo']
w_planetgc_forest02_alt1_b.dds	Mod	['w_planetgc_forest02.alo']
w_planetgc_forest03_alt0.dds	Mod	['w_planetgc_forest03.alo']
w_planetgc_forest03_alt0_b.dds	Mod	['w_planetgc_forest03.alo']
w_planetgc_forest03_alt1.dds	Mod	['w_planetgc_forest03.alo']
w_planetgc_forest03_alt1_b.dds	Mod	['w_planetgc_forest03.alo']
w_planetgc_forest04_alt0.dds	Mod	['w_planetgc_forest04.alo']
w_planetgc_forest04_alt0_b.dds	Mod	['w_planetgc_forest04.alo']
w_planetgc_forest04_alt1.dds	Mod	['w_planetgc_forest04.alo']
w_planetgc_forest04_alt1_b.dds	Mod	['w_planetgc_forest04.alo']
w_planetgc_forest_b.dds	Mod	['w_planetgc_forest.alo']
w_planetgc_gas.dds	Unused?	[]
w_planetgc_gas_b.dds	Mod	['w_planetgc_alarisprime.alo', 'w_planetgc_antar.alo', 'w_planetgc_bespin.alo', 'w_planetgc_endor.alo', 'w_planetgc_mustafar.alo', 'w_planetgc_telos.alo', 'w_planetgc_yavin4.alo']
w_planetgc_gas_blue.dds	Unused?	[]
w_planetgc_gas_blue_b.dds	Unused?	[]
w_planetgc_gas_green.dds	Unused?	[]
w_planetgc_gas_green_b.dds	Unused?	[]
w_planetgc_gas_red.dds	Unused?	[]
w_planetgc_gas_red_b.dds	Unused?	[]
w_planetgc_ice.dds	Mod	['w_planetgc_ice.alo']
w_planetgc_ice01.dds	Unused?	[]
w_planetgc_ice01_alt0.dds	Mod	['w_planetgc_ice01.alo']
w_planetgc_ice01_alt0_b.dds	Mod	['w_planetgc_ice01.alo']
w_planetgc_ice01_alt1.dds	Mod	['w_planetgc_ice01.alo']
w_planetgc_ice01_alt1_b.dds	Mod	['w_planetgc_ice01.alo']
w_planetgc_ice01_b.dds	Unused?	[]
w_planetgc_ice01_clouds_alt0.dds	Mod	['w_planetgc_ice01.alo', 'w_planetgc_ice02.alo', 'w_planetgc_ice03.alo', 'w_planetgc_ice04.alo', 'w_planetgc_kijimi.alo']
w_planetgc_ice01_clouds_alt1.dds	Mod	['w_planetgc_ice01.alo', 'w_planetgc_ice02.alo', 'w_planetgc_ice03.alo', 'w_planetgc_ice04.alo', 'w_planetgc_kijimi.alo']
w_planetgc_ice01_clouds_b_alt0.dds	Mod	['w_planetgc_ice01.alo', 'w_planetgc_ice02.alo', 'w_planetgc_ice03.alo', 'w_planetgc_ice04.alo', 'w_planetgc_kijimi.alo']
w_planetgc_ice01_clouds_b_alt1.dds	Mod	['w_planetgc_ice01.alo', 'w_planetgc_ice02.alo', 'w_planetgc_kijimi.alo']
w_planetgc_ice02_alt0.dds	Mod	['w_planetgc_ice02.alo']
w_planetgc_ice02_alt0_b.dds	Mod	['w_planetgc_ice02.alo']
w_planetgc_ice02_alt1.dds	Mod	['w_planetgc_ice02.alo']
w_planetgc_ice02_alt1_b.dds	Mod	['w_planetgc_ice02.alo', 'w_planetgc_ice03.alo', 'w_planetgc_ice04.alo']
w_planetgc_ice03_alt0.dds	Mod	['w_planetgc_ice03.alo']
w_planetgc_ice03_alt0_b.dds	Mod	['w_planetgc_ice03.alo']
w_planetgc_ice03_alt1.dds	Mod	['w_planetgc_ice03.alo']
w_planetgc_ice03_alt1_b.dds	Mod	['w_planetgc_ice03.alo']
w_planetgc_ice04_alt0.dds	Mod	['w_planetgc_ice04.alo']
w_planetgc_ice04_alt0_b.dds	Mod	['w_planetgc_ice04.alo']
w_planetgc_ice04_alt1.dds	Mod	['w_planetgc_ice04.alo']
w_planetgc_ice04_alt1_b.dds	Mod	['w_planetgc_ice04.alo']
w_planetgc_ice_b.dds	Mod	['w_planetgc_ice.alo']
w_planetgc_jedha_alt0.dds	Mod	['w_planetgc_jedha.alo']
w_planetgc_jedha_alt0_b.dds	Mod	['w_planetgc_jedha.alo']
w_planetgc_jedha_alt1.dds	Mod	['w_planetgc_jedha.alo']
w_planetgc_jedha_alt1_b.dds	Mod	['w_planetgc_jedha.alo']
w_planetgc_jestefad_alt0.dds	Mod	['w_planetgc_mustafar.alo']
w_planetgc_jestefad_alt1.dds	Mod	['w_planetgc_mustafar.alo']
w_planetgc_jungle01_alt0.dds	Mod	['w_planetgc_jungle01.alo']
w_planetgc_jungle01_alt0_b.dds	Mod	['w_planetgc_jungle01.alo']
w_planetgc_jungle01_alt1.dds	Mod	['w_planetgc_jungle01.alo']
w_planetgc_jungle01_alt1_b.dds	Mod	['w_planetgc_jungle01.alo']
w_planetgc_jungle01_clouds_alt0.dds	Mod	['w_planetgc_jungle01.alo', 'w_planetgc_jungle02.alo', 'w_planetgc_jungle03.alo', 'w_planetgc_jungle04.alo']
w_planetgc_jungle01_clouds_alt1.dds	Mod	['w_planetgc_jungle01.alo', 'w_planetgc_jungle02.alo', 'w_planetgc_jungle03.alo', 'w_planetgc_jungle04.alo']
w_planetgc_jungle01_clouds_b_alt0.dds	Mod	['w_planetgc_jungle01.alo', 'w_planetgc_jungle02.alo', 'w_planetgc_jungle03.alo', 'w_planetgc_jungle04.alo']
w_planetgc_jungle01_clouds_b_alt1.dds	Mod	['w_planetgc_jungle01.alo', 'w_planetgc_jungle02.alo', 'w_planetgc_jungle03.alo', 'w_planetgc_jungle04.alo']
w_planetgc_jungle02_alt0.dds	Mod	['w_planetgc_jungle02.alo']
w_planetgc_jungle02_alt0_b.dds	Mod	['w_planetgc_jungle02.alo']
w_planetgc_jungle02_alt1.dds	Mod	['w_planetgc_jungle02.alo']
w_planetgc_jungle02_alt1_b.dds	Mod	['w_planetgc_jungle02.alo']
w_planetgc_jungle03_alt0.dds	Mod	['w_planetgc_jungle03.alo']
w_planetgc_jungle03_alt0_b.dds	Mod	['w_planetgc_jungle03.alo']
w_planetgc_jungle03_alt1.dds	Mod	['w_planetgc_jungle03.alo']
w_planetgc_jungle03_alt1_b.dds	Mod	['w_planetgc_jungle03.alo']
w_planetgc_jungle04_alt0.dds	Mod	['w_planetgc_jungle04.alo']
w_planetgc_jungle04_alt0_b.dds	Mod	['w_planetgc_jungle04.alo']
w_planetgc_jungle04_alt1.dds	Mod	['w_planetgc_jungle04.alo']
w_planetgc_jungle04_alt1_b.dds	Mod	['w_planetgc_jungle04.alo']
w_planetgc_kijimi_alt0.dds	Mod	['w_planetgc_kijimi.alo']
w_planetgc_kijimi_alt0_b.dds	Mod	['w_planetgc_kijimi.alo']
w_planetgc_kijimi_alt1.dds	Mod	['w_planetgc_kijimi.alo']
w_planetgc_kijimi_alt1_b.dds	Mod	['w_planetgc_kijimi.alo']
w_planetgc_kuat_alt0.dds	Mod	['w_planetgc_kuat.alo']
w_planetgc_kuat_alt0_b.dds	Mod	['w_planetgc_kuat.alo']
w_planetgc_kuat_alt1.dds	Mod	['w_planetgc_kuat.alo']
w_planetgc_kuat_alt1_b.dds	Mod	['w_planetgc_kuat.alo']
w_planetgc_mixed01_alt0.dds	Mod	['w_planetgc_mixed01.alo']
w_planetgc_mixed01_alt0_b.dds	Mod	['w_planetgc_mixed01.alo']
w_planetgc_mixed01_alt1.dds	Mod	['w_planetgc_mixed01.alo']
w_planetgc_mixed01_alt1_b.dds	Mod	['w_planetgc_mixed01.alo']
w_planetgc_mixed02_alt0.dds	Mod	['w_planetgc_mixed02.alo']
w_planetgc_mixed02_alt0_b.dds	Mod	['w_planetgc_mixed02.alo']
w_planetgc_mixed02_alt1.dds	Mod	['w_planetgc_mixed02.alo']
w_planetgc_mixed02_alt1_b.dds	Mod	['w_planetgc_mixed02.alo']
w_planetgc_mixed03_alt0.dds	Mod	['w_planetgc_mixed03.alo']
w_planetgc_mixed03_alt0_b.dds	Mod	['w_planetgc_mixed03.alo']
w_planetgc_mixed03_alt1.dds	Mod	['w_planetgc_mixed03.alo']
w_planetgc_mixed03_alt1_b.dds	Mod	['w_planetgc_mixed03.alo']
w_planetgc_mixed03_l_alt0.dds	Mod	['w_planetgc_mixed03.alo']
w_planetgc_mixed03_l_alt1.dds	Mod	['w_planetgc_mixed03.alo']
w_planetgc_mixed04_alt0.dds	Mod	['w_planetgc_mixed04.alo']
w_planetgc_mixed04_alt0_b.dds	Mod	['w_planetgc_mixed04.alo']
w_planetgc_mixed04_alt1.dds	Mod	['w_planetgc_mixed04.alo']
w_planetgc_mixed04_alt1_b.dds	Mod	['w_planetgc_mixed04.alo']
w_planetgc_mountain01_alt0.dds	Mod	['w_planetgc_mountain01.alo']
w_planetgc_mountain01_alt0_b.dds	Mod	['w_planetgc_mountain01.alo']
w_planetgc_mountain01_alt1.dds	Mod	['w_planetgc_mountain01.alo']
w_planetgc_mountain01_alt1_b.dds	Mod	['w_planetgc_mountain01.alo']
w_planetgc_mountain01_clouds_alt0.dds	Mod	['w_planetgc_mountain01.alo', 'w_planetgc_mountain02.alo', 'w_planetgc_mountain03.alo', 'w_planetgc_mountain04.alo']
w_planetgc_mountain01_clouds_alt0_b.dds	Mod	['w_planetgc_mountain01.alo', 'w_planetgc_mountain02.alo', 'w_planetgc_mountain03.alo', 'w_planetgc_mountain04.alo']
w_planetgc_mountain01_clouds_alt1.dds	Mod	['w_planetgc_mountain01.alo', 'w_planetgc_mountain02.alo', 'w_planetgc_mountain03.alo', 'w_planetgc_mountain04.alo']
w_planetgc_mountain01_clouds_alt1_b.dds	Mod	['w_planetgc_mountain01.alo', 'w_planetgc_mountain02.alo', 'w_planetgc_mountain03.alo', 'w_planetgc_mountain04.alo']
w_planetgc_mountain02_alt0.dds	Mod	['w_planetgc_mountain02.alo']
w_planetgc_mountain02_alt0_b.dds	Mod	['w_planetgc_mountain02.alo']
w_planetgc_mountain02_alt1.dds	Mod	['w_planetgc_mountain02.alo']
w_planetgc_mountain02_alt1_b.dds	Mod	['w_planetgc_mountain02.alo']
w_planetgc_mountain03_alt0.dds	Mod	['w_planetgc_mountain03.alo']
w_planetgc_mountain03_alt0_b.dds	Mod	['w_planetgc_mountain03.alo']
w_planetgc_mountain03_alt1.dds	Mod	['w_planetgc_mountain03.alo']
w_planetgc_mountain03_alt1_b.dds	Mod	['w_planetgc_mountain03.alo']
w_planetgc_mountain04_alt0.dds	Mod	['w_planetgc_mountain04.alo']
w_planetgc_mountain04_alt0_b.dds	Mod	['w_planetgc_mountain04.alo']
w_planetgc_mountain04_alt1.dds	Mod	['w_planetgc_mountain04.alo']
w_planetgc_mountain04_alt1_b.dds	Mod	['w_planetgc_mountain04.alo']
w_planetgc_mountain_temperate01_alt0.dds	Mod	['w_planetgc_mountain_temperate01.alo']
w_planetgc_mountain_temperate01_alt0_b.dds	Mod	['w_planetgc_mountain_temperate01.alo', 'w_planetgc_mountain_temperate02.alo']
w_planetgc_mountain_temperate01_alt1.dds	Mod	['w_planetgc_mountain_temperate01.alo']
w_planetgc_mountain_temperate01_alt1_b.dds	Mod	['w_planetgc_mountain_temperate01.alo']
w_planetgc_mountain_temperate02_alt0.dds	Mod	['w_planetgc_mountain_temperate02.alo']
w_planetgc_mountain_temperate02_alt0_b.dds	Unused?	[]
w_planetgc_mountain_temperate02_alt1.dds	Mod	['w_planetgc_mountain_temperate02.alo']
w_planetgc_mountain_temperate02_alt1_b.dds	Mod	['w_planetgc_mountain_temperate02.alo']
w_planetgc_mountain_temperate03_alt0.dds	Mod	['w_planetgc_mountain_temperate03.alo']
w_planetgc_mountain_temperate03_alt0_b.dds	Mod	['w_planetgc_mountain_temperate03.alo']
w_planetgc_mountain_temperate03_alt1.dds	Mod	['w_planetgc_mountain_temperate03.alo']
w_planetgc_mountain_temperate03_alt1_b.dds	Mod	['w_planetgc_mountain_temperate03.alo']
w_planetgc_mountain_temperate04_alt0.dds	Mod	['w_planetgc_mountain_temperate04.alo']
w_planetgc_mountain_temperate04_alt0_b.dds	Mod	['w_planetgc_mountain_temperate04.alo']
w_planetgc_mountain_temperate04_alt1.dds	Mod	['w_planetgc_mountain_temperate04.alo']
w_planetgc_mountain_temperate04_alt1_b.dds	Mod	['w_planetgc_mountain_temperate04.alo']
w_planetgc_mounttemperate01_clouds_alt0.dds	Mod	['w_planetgc_mountain_temperate01.alo', 'w_planetgc_mountain_temperate02.alo', 'w_planetgc_mountain_temperate03.alo', 'w_planetgc_mountain_temperate04.alo']
w_planetgc_mounttemperate01_clouds_alt0_b.dds	Mod	['w_planetgc_desert01.alo', 'w_planetgc_desert02.alo', 'w_planetgc_desert03.alo', 'w_planetgc_desert04.alo', 'w_planetgc_mountain_temperate01.alo', 'w_planetgc_mountain_temperate02.alo', 'w_planetgc_mountain_temperate03.alo', 'w_planetgc_mountain_temperate04.alo']
w_planetgc_mounttemperate01_clouds_alt1.dds	Mod	['w_planetgc_mountain_temperate01.alo', 'w_planetgc_mountain_temperate02.alo', 'w_planetgc_mountain_temperate03.alo', 'w_planetgc_mountain_temperate04.alo']
w_planetgc_mounttemperate01_clouds_alt1_b.dds	Mod	['w_planetgc_mountain_temperate01.alo', 'w_planetgc_mountain_temperate02.alo', 'w_planetgc_mountain_temperate03.alo', 'w_planetgc_mountain_temperate04.alo']
w_planetgc_mustafar_alt0.dds	Mod	['w_planetgc_mustafar.alo']
w_planetgc_mustafar_alt0_b.dds	Mod	['w_planetgc_mustafar.alo']
w_planetgc_mustafar_alt0_l.dds	Unused?	[]
w_planetgc_mustafar_alt1.dds	Mod	['w_planetgc_mustafar.alo']
w_planetgc_mustafar_alt1_b.dds	Mod	['w_planetgc_mustafar.alo']
w_planetgc_mustafar_alt1_l.dds	Mod	['w_planetgc_mustafar.alo']
w_planetgc_najedha_alt0.dds	Mod	['w_planetgc_jedha.alo']
w_planetgc_najedha_alt0_b.dds	Mod	['w_planetgc_jedha.alo']
w_planetgc_najedha_alt1.dds	Mod	['w_planetgc_jedha.alo']
w_planetgc_najedha_alt1_b.dds	Mod	['w_planetgc_jedha.alo']
w_planetgc_nallhutta_alt0.dds	Mod	['w_planetgc_nallhutta.alo']
w_planetgc_nallhutta_alt0_b.dds	Mod	['w_planetgc_nallhutta.alo']
w_planetgc_nallhutta_alt1.dds	Mod	['w_planetgc_nallhutta.alo']
w_planetgc_nallhutta_alt1_b.dds	Mod	['w_planetgc_nallhutta.alo']
w_planetgc_nallhutta_rings.dds	Mod	['w_planetgc_nallhutta.alo']
w_planetgc_narrshaddaa_alt0.dds	Mod	['w_planetgc_nallhutta.alo']
w_planetgc_narrshaddaa_alt0_b.dds	Mod	['w_planetgc_nallhutta.alo']
w_planetgc_narrshaddaa_alt1.dds	Mod	['w_planetgc_nallhutta.alo']
w_planetgc_narrshaddaa_alt1_b.dds	Mod	['w_planetgc_nallhutta.alo']
w_planetgc_narrshaddaa_alt1_l.dds	Mod	['w_planetgc_nallhutta.alo']
w_planetgc_ocean.dds	Mod	['w_planetgc_ocean.alo']
w_planetgc_ocean_b.dds	Mod	['w_planetgc_ocean.alo']
w_planetgc_peridea_alt0.dds	Mod	['w_planetgc_peridea.alo']
w_planetgc_peridea_alt0_b.dds	Mod	['w_planetgc_peridea.alo']
w_planetgc_peridea_alt1.dds	Mod	['w_planetgc_peridea.alo']
w_planetgc_peridea_alt1_b.dds	Mod	['w_planetgc_peridea.alo']
w_planetgc_peridea_rings.dds	Mod	['w_planetgc_peridea.alo']
w_planetgc_savann01_alt0.dds	Mod	['w_planetgc_savann01.alo']
w_planetgc_savann01_alt0_b.dds	Mod	['w_planetgc_savann01.alo']
w_planetgc_savann01_alt1.dds	Mod	['w_planetgc_savann01.alo']
w_planetgc_savann01_alt1_b.dds	Mod	['w_planetgc_savann01.alo']
w_planetgc_savann01_clouds_alt0.dds	Mod	['w_planetgc_savann01.alo', 'w_planetgc_savann02.alo', 'w_planetgc_savann03.alo', 'w_planetgc_savann04.alo']
w_planetgc_savann01_clouds_alt1.dds	Mod	['w_planetgc_savann01.alo', 'w_planetgc_savann02.alo', 'w_planetgc_savann03.alo', 'w_planetgc_savann04.alo']
w_planetgc_savann01_clouds_b_alt0.dds	Mod	['w_planetgc_savann01.alo', 'w_planetgc_savann02.alo', 'w_planetgc_savann03.alo', 'w_planetgc_savann04.alo']
w_planetgc_savann01_clouds_b_alt1.dds	Mod	['w_planetgc_savann01.alo', 'w_planetgc_savann02.alo', 'w_planetgc_savann03.alo']
w_planetgc_savann02_alt0.dds	Mod	['w_planetgc_savann02.alo']
w_planetgc_savann02_alt0_b.dds	Mod	['w_planetgc_savann02.alo']
w_planetgc_savann02_alt1.dds	Mod	['w_planetgc_savann02.alo']
w_planetgc_savann02_alt1_b.dds	Mod	['w_planetgc_savann02.alo']
w_planetgc_savann03_alt0.dds	Mod	['w_planetgc_savann03.alo']
w_planetgc_savann03_alt0_b.dds	Mod	['w_planetgc_savann03.alo']
w_planetgc_savann03_alt1.dds	Mod	['w_planetgc_savann03.alo']
w_planetgc_savann03_alt1_b.dds	Mod	['w_planetgc_savann03.alo']
w_planetgc_savann04_alt0.dds	Mod	['w_planetgc_savann04.alo']
w_planetgc_savann04_alt0_b.dds	Mod	['w_planetgc_savann04.alo']
w_planetgc_savann04_alt1.dds	Mod	['w_planetgc_savann04.alo']
w_planetgc_savann04_alt1_b.dds	Mod	['w_planetgc_savann04.alo']
w_planetgc_seatos_alt0.dds	Mod	['w_planetgc_seatos.alo']
w_planetgc_seatos_alt0_b.dds	Mod	['w_planetgc_seatos.alo']
w_planetgc_seatos_alt1.dds	Mod	['w_planetgc_seatos.alo']
w_planetgc_seatos_alt1_b.dds	Mod	['w_planetgc_seatos.alo']
w_planetgc_steppen01_alt0.dds	Mod	['w_planetgc_antar.alo', 'w_planetgc_steppen01.alo']
w_planetgc_steppen01_alt0_b.dds	Mod	['w_planetgc_antar.alo', 'w_planetgc_steppen01.alo']
w_planetgc_steppen01_alt1.dds	Mod	['w_planetgc_antar.alo', 'w_planetgc_steppen01.alo']
w_planetgc_steppen01_alt1_b.dds	Mod	['w_planetgc_antar.alo', 'w_planetgc_steppen01.alo']
w_planetgc_steppen01_clouds_alt0.dds	Mod	['w_planetgc_antar.alo', 'w_planetgc_steppen01.alo', 'w_planetgc_steppen02.alo', 'w_planetgc_steppen03.alo', 'w_planetgc_steppen04.alo']
w_planetgc_steppen01_clouds_alt1.dds	Mod	['w_planetgc_antar.alo', 'w_planetgc_steppen01.alo', 'w_planetgc_steppen02.alo', 'w_planetgc_steppen03.alo', 'w_planetgc_steppen04.alo']
w_planetgc_steppen01_clouds_b_alt0.dds	Mod	['w_planetgc_antar.alo', 'w_planetgc_steppen01.alo', 'w_planetgc_steppen02.alo', 'w_planetgc_steppen03.alo', 'w_planetgc_steppen04.alo']
w_planetgc_steppen01_clouds_b_alt1.dds	Mod	['w_planetgc_antar.alo', 'w_planetgc_steppen01.alo', 'w_planetgc_steppen02.alo', 'w_planetgc_steppen03.alo', 'w_planetgc_steppen04.alo']
w_planetgc_steppen02_alt0.dds	Mod	['w_planetgc_steppen02.alo']
w_planetgc_steppen02_alt0_b.dds	Mod	['w_planetgc_steppen02.alo']
w_planetgc_steppen02_alt1.dds	Mod	['w_planetgc_steppen02.alo']
w_planetgc_steppen02_alt1_b.dds	Mod	['w_planetgc_steppen02.alo']
w_planetgc_steppen03_alt0.dds	Mod	['w_planetgc_steppen03.alo']
w_planetgc_steppen03_alt0_b.dds	Mod	['w_planetgc_steppen03.alo']
w_planetgc_steppen03_alt1.dds	Unused?	[]
w_planetgc_steppen03_alt1_b.dds	Mod	['w_planetgc_steppen03.alo']
w_planetgc_steppen04_alt0.dds	Mod	['w_planetgc_steppen04.alo']
w_planetgc_steppen04_alt0_b.dds	Mod	['w_planetgc_steppen04.alo']
w_planetgc_steppen04_alt1.dds	Mod	['w_planetgc_steppen04.alo']
w_planetgc_steppen04_alt1_b.dds	Mod	['w_planetgc_steppen04.alo']
w_planetgc_swamp.dds	Mod	['w_planetgc_swamp.alo']
w_planetgc_swamp01.dds	Unused?	[]
w_planetgc_swamp01_alt0.dds	Mod	['w_planetgc_swamp01.alo']
w_planetgc_swamp01_alt0_b.dds	Mod	['w_planetgc_swamp01.alo']
w_planetgc_swamp01_alt1.dds	Mod	['w_planetgc_swamp01.alo']
w_planetgc_swamp01_alt1_b.dds	Mod	['w_planetgc_swamp01.alo']
w_planetgc_swamp01_b.dds	Unused?	[]
w_planetgc_swamp01_clouds_alt0.dds	Mod	['w_planetgc_nallhutta.alo', 'w_planetgc_swamp01.alo', 'w_planetgc_swamp02.alo', 'w_planetgc_swamp03.alo', 'w_planetgc_swamp04.alo']
w_planetgc_swamp01_clouds_alt1.dds	Mod	['w_planetgc_nallhutta.alo', 'w_planetgc_swamp01.alo', 'w_planetgc_swamp02.alo', 'w_planetgc_swamp03.alo', 'w_planetgc_swamp04.alo']
w_planetgc_swamp01_clouds_b_alt0.dds	Mod	['w_planetgc_nallhutta.alo', 'w_planetgc_swamp01.alo', 'w_planetgc_swamp02.alo', 'w_planetgc_swamp03.alo', 'w_planetgc_swamp04.alo']
w_planetgc_swamp01_clouds_b_alt1.dds	Mod	['w_planetgc_nallhutta.alo', 'w_planetgc_swamp01.alo', 'w_planetgc_swamp02.alo', 'w_planetgc_swamp03.alo', 'w_planetgc_swamp04.alo']
w_planetgc_swamp02_alt0.dds	Mod	['w_planetgc_swamp02.alo']
w_planetgc_swamp02_alt0_b.dds	Mod	['w_planetgc_swamp02.alo']
w_planetgc_swamp02_alt1.dds	Mod	['w_planetgc_swamp02.alo']
w_planetgc_swamp02_alt1_b.dds	Mod	['w_planetgc_swamp02.alo']
w_planetgc_swamp03_alt0.dds	Mod	['w_planetgc_swamp03.alo']
w_planetgc_swamp03_alt0_b.dds	Mod	['w_planetgc_swamp03.alo']
w_planetgc_swamp03_alt1.dds	Mod	['w_planetgc_swamp03.alo']
w_planetgc_swamp03_alt1_b.dds	Mod	['w_planetgc_swamp03.alo']
w_planetgc_swamp04_alt0.dds	Mod	['w_planetgc_swamp04.alo']
w_planetgc_swamp04_alt0_b.dds	Mod	['w_planetgc_swamp04.alo']
w_planetgc_swamp04_alt1.dds	Mod	['w_planetgc_swamp04.alo']
w_planetgc_swamp04_alt1_b.dds	Mod	['w_planetgc_swamp04.alo']
w_planetgc_swamp_b.dds	Mod	['w_planetgc_swamp.alo']
w_planetgc_taiga01_alt0.dds	Mod	['w_planetgc_taiga01.alo']
w_planetgc_taiga01_alt0_b.dds	Mod	['w_planetgc_taiga01.alo']
w_planetgc_taiga01_alt1.dds	Mod	['w_planetgc_taiga01.alo']
w_planetgc_taiga01_alt1_b.dds	Mod	['w_planetgc_taiga01.alo']
w_planetgc_taiga01_clouds_alt0.dds	Mod	['w_planetgc_taiga01.alo', 'w_planetgc_taiga02.alo', 'w_planetgc_taiga03.alo', 'w_planetgc_taiga04.alo']
w_planetgc_taiga01_clouds_alt0_b.dds	Mod	['w_planetgc_taiga01.alo', 'w_planetgc_taiga02.alo', 'w_planetgc_taiga03.alo', 'w_planetgc_taiga04.alo']
w_planetgc_taiga01_clouds_alt1.dds	Mod	['w_planetgc_taiga01.alo', 'w_planetgc_taiga02.alo', 'w_planetgc_taiga03.alo', 'w_planetgc_taiga04.alo']
w_planetgc_taiga01_clouds_alt1_b.dds	Mod	['w_planetgc_taiga01.alo', 'w_planetgc_taiga02.alo', 'w_planetgc_taiga03.alo', 'w_planetgc_taiga04.alo']
w_planetgc_taiga02_alt0.dds	Mod	['w_planetgc_taiga02.alo']
w_planetgc_taiga02_alt0_b.dds	Mod	['w_planetgc_taiga02.alo']
w_planetgc_taiga02_alt1.dds	Mod	['w_planetgc_taiga02.alo']
w_planetgc_taiga02_alt1_b.dds	Mod	['w_planetgc_taiga02.alo']
w_planetgc_taiga03_alt0.dds	Mod	['w_planetgc_taiga03.alo']
w_planetgc_taiga03_alt0_b.dds	Mod	['w_planetgc_taiga03.alo']
w_planetgc_taiga03_alt1.dds	Mod	['w_planetgc_taiga03.alo']
w_planetgc_taiga03_alt1_b.dds	Mod	['w_planetgc_taiga03.alo']
w_planetgc_taiga04_alt0.dds	Mod	['w_planetgc_taiga04.alo']
w_planetgc_taiga04_alt0_b.dds	Mod	['w_planetgc_taiga04.alo']
w_planetgc_taiga04_alt1.dds	Mod	['w_planetgc_taiga04.alo']
w_planetgc_taiga04_alt1_b.dds	Mod	['w_planetgc_taiga04.alo']
w_planetgc_telos_alt0.dds	Mod	['w_planetgc_telos.alo']
w_planetgc_telos_alt0_b.dds	Mod	['w_planetgc_telos.alo']
w_planetgc_telos_alt1.dds	Mod	['w_planetgc_telos.alo']
w_planetgc_telos_alt1_b.dds	Mod	['w_planetgc_telos.alo']
w_planetgc_telos_grid.dds	Mod	['w_planetgc_telos.alo']
w_planetgc_temperate.dds	Mod	['w_planetgc_temperate.alo']
w_planetgc_temperate01.dds	Unused?	[]
w_planetgc_temperate01_alt0.dds	Mod	['w_planetgc_temperate01.alo']
w_planetgc_temperate01_alt0_b.dds	Mod	['w_planetgc_temperate01.alo']
w_planetgc_temperate01_alt1.dds	Mod	['w_planetgc_temperate01.alo']
w_planetgc_temperate01_alt1_b.dds	Mod	['w_planetgc_temperate01.alo']
w_planetgc_temperate01_alt1_l.dds	Mod	['w_planetgc_seatos.alo', 'w_planetgc_temperate01.alo']
w_planetgc_temperate01_b.dds	Unused?	[]
w_planetgc_temperate01_clouds.dds	Unused?	[]
w_planetgc_temperate01_clouds_alt0.dds	Mod	['w_planetgc_seatos.alo', 'w_planetgc_temperate01.alo', 'w_planetgc_temperate02.alo', 'w_planetgc_temperate03.alo', 'w_planetgc_temperate04.alo']
w_planetgc_temperate01_clouds_alt1.dds	Mod	['w_planetgc_seatos.alo', 'w_planetgc_temperate01.alo', 'w_planetgc_temperate02.alo', 'w_planetgc_temperate03.alo', 'w_planetgc_temperate04.alo']
w_planetgc_temperate01_clouds_b.dds	Unused?	[]
w_planetgc_temperate01_clouds_b_alt0.dds	Mod	['w_planetgc_seatos.alo', 'w_planetgc_temperate01.alo', 'w_planetgc_temperate02.alo', 'w_planetgc_temperate03.alo', 'w_planetgc_temperate04.alo']
w_planetgc_temperate01_clouds_b_alt1.dds	Mod	['w_planetgc_seatos.alo', 'w_planetgc_temperate01.alo', 'w_planetgc_temperate02.alo', 'w_planetgc_temperate03.alo', 'w_planetgc_temperate04.alo']
w_planetgc_temperate02.dds	Unused?	[]
w_planetgc_temperate02_alt0.dds	Mod	['w_planetgc_temperate02.alo']
w_planetgc_temperate02_alt0_b.dds	Mod	['w_planetgc_temperate02.alo']
w_planetgc_temperate02_alt1.dds	Mod	['w_planetgc_temperate02.alo']
w_planetgc_temperate02_alt1_b.dds	Mod	['w_planetgc_temperate02.alo']
w_planetgc_temperate02_alt1_l.dds	Mod	['w_planetgc_temperate02.alo']
w_planetgc_temperate02_b.dds	Unused?	[]
w_planetgc_temperate02_clouds.dds	Unused?	[]
w_planetgc_temperate02_clouds_b.dds	Unused?	[]
w_planetgc_temperate03.dds	Unused?	[]
w_planetgc_temperate03_alt0.dds	Mod	['w_planetgc_temperate03.alo']
w_planetgc_temperate03_alt0_b.dds	Mod	['w_planetgc_temperate03.alo']
w_planetgc_temperate03_alt1.dds	Mod	['w_planetgc_temperate03.alo']
w_planetgc_temperate03_alt1_b.dds	Mod	['w_planetgc_temperate03.alo']
w_planetgc_temperate03_alt1_l.dds	Mod	['w_planetgc_temperate03.alo']
w_planetgc_temperate03_b.dds	Unused?	[]
w_planetgc_temperate03_clouds.dds	Unused?	[]
w_planetgc_temperate03_clouds_b.dds	Unused?	[]
w_planetgc_temperate04.dds	Unused?	[]
w_planetgc_temperate04_alt0.dds	Mod	['w_planetgc_temperate04.alo']
w_planetgc_temperate04_alt0_b.dds	Mod	['w_planetgc_temperate04.alo']
w_planetgc_temperate04_alt1.dds	Mod	['w_planetgc_temperate04.alo']
w_planetgc_temperate04_alt1_b.dds	Mod	['w_planetgc_temperate04.alo']
w_planetgc_temperate04_alt1_l.dds	Mod	['w_planetgc_temperate04.alo']
w_planetgc_temperate04_b.dds	Unused?	[]
w_planetgc_temperate04_clouds.dds	Unused?	[]
w_planetgc_temperate04_clouds_b.dds	Unused?	[]
w_planetgc_temperate_b.dds	Mod	['w_planetgc_temperate.alo']
w_planetgc_tundra01_alt0.dds	Mod	['w_planetgc_tundra01.alo']
w_planetgc_tundra01_alt0_b.dds	Mod	['w_planetgc_tundra01.alo']
w_planetgc_tundra01_alt1.dds	Mod	['w_planetgc_tundra01.alo']
w_planetgc_tundra01_alt1_b.dds	Mod	['w_planetgc_tundra01.alo']
w_planetgc_tundra01_clouds_alt0.dds	Mod	['w_planetgc_peridea.alo', 'w_planetgc_tundra01.alo', 'w_planetgc_tundra02.alo', 'w_planetgc_tundra03.alo', 'w_planetgc_tundra04.alo']
w_planetgc_tundra01_clouds_alt1.dds	Mod	['w_planetgc_peridea.alo', 'w_planetgc_tundra01.alo', 'w_planetgc_tundra02.alo', 'w_planetgc_tundra03.alo', 'w_planetgc_tundra04.alo']
w_planetgc_tundra01_clouds_b_alt0.dds	Mod	['w_planetgc_peridea.alo', 'w_planetgc_tundra01.alo', 'w_planetgc_tundra02.alo', 'w_planetgc_tundra03.alo', 'w_planetgc_tundra04.alo']
w_planetgc_tundra01_clouds_b_alt1.dds	Mod	['w_planetgc_peridea.alo', 'w_planetgc_tundra01.alo', 'w_planetgc_tundra02.alo', 'w_planetgc_tundra03.alo', 'w_planetgc_tundra04.alo']
w_planetgc_tundra02_alt0.dds	Mod	['w_planetgc_tundra02.alo']
w_planetgc_tundra02_alt0_b.dds	Mod	['w_planetgc_tundra02.alo']
w_planetgc_tundra02_alt1.dds	Mod	['w_planetgc_tundra02.alo']
w_planetgc_tundra02_alt1_b.dds	Mod	['w_planetgc_tundra02.alo']
w_planetgc_tundra03_alt0.dds	Mod	['w_planetgc_tundra03.alo']
w_planetgc_tundra03_alt0_b.dds	Mod	['w_planetgc_tundra03.alo']
w_planetgc_tundra03_alt1.dds	Mod	['w_planetgc_tundra03.alo']
w_planetgc_tundra03_alt1_b.dds	Mod	['w_planetgc_tundra03.alo']
w_planetgc_tundra04_alt0.dds	Mod	['w_planetgc_tundra04.alo']
w_planetgc_tundra04_alt0_b.dds	Mod	['w_planetgc_tundra04.alo']
w_planetgc_tundra04_alt1.dds	Mod	['w_planetgc_tundra04.alo']
w_planetgc_tundra04_alt1_b.dds	Mod	['w_planetgc_tundra04.alo']
w_planetgc_urban.dds	Mod	['w_planetgc_urban.alo']
w_planetgc_urban01.dds	Unused?	[]
w_planetgc_urban01_alt0.dds	Mod	['w_planetgc_urban01.alo']
w_planetgc_urban01_alt0_b.dds	Mod	['w_planetgc_urban01.alo']
w_planetgc_urban01_alt0_l.dds	Unused?	[]
w_planetgc_urban01_alt1.dds	Mod	['w_planetgc_urban01.alo']
w_planetgc_urban01_alt1_b.dds	Mod	['w_planetgc_urban01.alo']
w_planetgc_urban01_alt1_l.dds	Mod	['w_planetgc_urban01.alo']
w_planetgc_urban01_b.dds	Unused?	[]
w_planetgc_urban01_clouds_alt0.dds	Mod	['w_planetgc_christophsis.alo', 'w_planetgc_coruscant.alo', 'w_planetgc_exogol.alo', 'w_planetgc_nallhutta.alo', 'w_planetgc_telos.alo', 'w_planetgc_urban01.alo', 'w_planetgc_urban02.alo', 'w_planetgc_urban03.alo', 'w_planetgc_urban04.alo']
w_planetgc_urban01_clouds_alt1.dds	Mod	['w_planetgc_christophsis.alo', 'w_planetgc_coruscant.alo', 'w_planetgc_exogol.alo', 'w_planetgc_nallhutta.alo', 'w_planetgc_telos.alo', 'w_planetgc_urban01.alo', 'w_planetgc_urban02.alo', 'w_planetgc_urban03.alo', 'w_planetgc_urban04.alo']
w_planetgc_urban01_clouds_b_alt0.dds	Mod	['w_planetgc_christophsis.alo', 'w_planetgc_coruscant.alo', 'w_planetgc_exogol.alo', 'w_planetgc_nallhutta.alo', 'w_planetgc_telos.alo', 'w_planetgc_urban01.alo', 'w_planetgc_urban02.alo', 'w_planetgc_urban03.alo', 'w_planetgc_urban04.alo']
w_planetgc_urban01_clouds_b_alt1.dds	Mod	['w_planetgc_christophsis.alo', 'w_planetgc_coruscant.alo', 'w_planetgc_exogol.alo', 'w_planetgc_nallhutta.alo', 'w_planetgc_telos.alo', 'w_planetgc_urban01.alo', 'w_planetgc_urban02.alo', 'w_planetgc_urban03.alo', 'w_planetgc_urban04.alo']
w_planetgc_urban02_alt0.dds	Mod	['w_planetgc_urban02.alo']
w_planetgc_urban02_alt0_b.dds	Mod	['w_planetgc_urban02.alo']
w_planetgc_urban02_alt0_l.dds	Unused?	[]
w_planetgc_urban02_alt1.dds	Mod	['w_planetgc_urban02.alo']
w_planetgc_urban02_alt1_b.dds	Mod	['w_planetgc_urban02.alo']
w_planetgc_urban02_alt1_l.dds	Mod	['w_planetgc_urban02.alo']
w_planetgc_urban03_alt0.dds	Mod	['w_planetgc_urban03.alo']
w_planetgc_urban03_alt0_b.dds	Mod	['w_planetgc_urban03.alo']
w_planetgc_urban03_alt0_l.dds	Unused?	[]
w_planetgc_urban03_alt1.dds	Mod	['w_planetgc_urban03.alo']
w_planetgc_urban03_alt1_b.dds	Mod	['w_planetgc_urban03.alo']
w_planetgc_urban03_alt1_l.dds	Mod	['w_planetgc_urban03.alo']
w_planetgc_urban04_alt0.dds	Mod	['w_planetgc_urban04.alo']
w_planetgc_urban04_alt0_b.dds	Mod	['w_planetgc_urban04.alo']
w_planetgc_urban04_alt0_l.dds	Unused?	[]
w_planetgc_urban04_alt1.dds	Mod	['w_planetgc_urban04.alo']
w_planetgc_urban04_alt1_b.dds	Mod	['w_planetgc_urban04.alo']
w_planetgc_urban04_alt1_l.dds	Mod	['w_planetgc_urban04.alo']
w_planetgc_urban_b.dds	Mod	['w_planetgc_urban.alo']
w_planetgc_volcanic.dds	Mod	['w_planetgc_volcanic.alo']
w_planetgc_volcanic01.dds	Unused?	[]
w_planetgc_volcanic01_alt0.dds	Mod	['w_planetgc_volcanic01.alo']
w_planetgc_volcanic01_alt0_b.dds	Mod	['w_planetgc_volcanic01.alo']
w_planetgc_volcanic01_alt1.dds	Mod	['w_planetgc_volcanic01.alo']
w_planetgc_volcanic01_alt1_b.dds	Mod	['w_planetgc_volcanic01.alo']
w_planetgc_volcanic01_alt1_l.dds	Mod	['w_planetgc_volcanic01.alo']
w_planetgc_volcanic01_b.dds	Unused?	[]
w_planetgc_volcanic01_clouds_alt0.dds	Mod	['w_planetgc_volcanic01.alo', 'w_planetgc_volcanic02.alo', 'w_planetgc_volcanic03.alo', 'w_planetgc_volcanic04.alo']
w_planetgc_volcanic01_clouds_alt0_b.dds	Mod	['w_planetgc_volcanic01.alo', 'w_planetgc_volcanic02.alo', 'w_planetgc_volcanic03.alo', 'w_planetgc_volcanic04.alo']
w_planetgc_volcanic01_clouds_alt1.dds	Mod	['w_planetgc_volcanic01.alo', 'w_planetgc_volcanic02.alo', 'w_planetgc_volcanic03.alo', 'w_planetgc_volcanic04.alo']
w_planetgc_volcanic01_clouds_alt1_b.dds	Mod	['w_planetgc_volcanic01.alo', 'w_planetgc_volcanic02.alo', 'w_planetgc_volcanic03.alo', 'w_planetgc_volcanic04.alo']
w_planetgc_volcanic01_l.dds	Unused?	[]
w_planetgc_volcanic02_alt0.dds	Mod	['w_planetgc_volcanic02.alo']
w_planetgc_volcanic02_alt0_b.dds	Mod	['w_planetgc_volcanic02.alo']
w_planetgc_volcanic02_alt1.dds	Mod	['w_planetgc_volcanic02.alo']
w_planetgc_volcanic02_alt1_b.dds	Mod	['w_planetgc_volcanic02.alo']
w_planetgc_volcanic02_alt1_l.dds	Mod	['w_planetgc_volcanic02.alo']
w_planetgc_volcanic03_alt0.dds	Mod	['w_planetgc_volcanic03.alo']
w_planetgc_volcanic03_alt0_b.dds	Mod	['w_planetgc_volcanic03.alo']
w_planetgc_volcanic03_alt1.dds	Mod	['w_planetgc_volcanic03.alo']
w_planetgc_volcanic03_alt1_b.dds	Mod	['w_planetgc_volcanic03.alo']
w_planetgc_volcanic03_alt1_l.dds	Mod	['w_planetgc_volcanic03.alo']
w_planetgc_volcanic04_alt0.dds	Mod	['w_planetgc_volcanic04.alo']
w_planetgc_volcanic04_alt0_b.dds	Mod	['w_planetgc_volcanic04.alo']
w_planetgc_volcanic04_alt1.dds	Mod	['w_planetgc_volcanic04.alo']
w_planetgc_volcanic04_alt1_b.dds	Mod	['w_planetgc_volcanic04.alo']
w_planetgc_volcanic04_alt1_l.dds	Mod	['w_planetgc_volcanic04.alo']
w_planetgc_volcanic_b.dds	Mod	['w_planetgc_volcanic.alo']
w_planetgc_yavin4_alt0.dds	Mod	['w_planetgc_yavin4.alo']
w_planetgc_yavin4_alt0_b.dds	Mod	['w_planetgc_yavin4.alo']
w_planetgc_yavin4_alt1.dds	Mod	['w_planetgc_yavin4.alo']
w_planetgc_yavin4_alt1_b.dds	Mod	['w_planetgc_yavin4.alo']
w_planetgc_yavin_gas_alt0.dds	Mod	['w_planetgc_antar.alo', 'w_planetgc_yavin4.alo']
w_planetgc_yavin_gas_alt0_b.dds	Unused?	[]
w_planetgc_yavin_gas_alt1.dds	Mod	['w_planetgc_antar.alo', 'w_planetgc_yavin4.alo']
w_planetgc_yavin_gas_alt1_b.dds	Unused?	[]
w_planetprop_atmosphere_blue.dds	Mod	['w_planetprop_temperate.alo']
w_planetrings.dds	Unused?	[]
w_planet_atmosphere_white.dds	Mod	['w_planetgc_desert.alo', 'w_planetgc_forest.alo', 'w_planetgc_ice.alo', 'w_planetgc_ocean.alo', 'w_planetgc_swamp.alo', 'w_planetgc_temperate.alo', 'w_planetgc_urban.alo', 'w_planetgc_volcanic.alo']
w_planet_prop_deathstar.dds	Unused?	[]
w_planet_prop_deathstar2.dds	Unused?	[]
w_planet_urban_l.dds	Mod	['w_planetgc_urban.alo']
w_planet_urban_l01.dds	Unused?	[]
w_projectile_concussion_missile_b.dds	Mod	['w_projectile_concussion_missile_b.alo']
w_projectile_fighter.dds	Mod	['w_fighter_turbolaser_g.alo']
w_projectile_infantry.dds	Unused?	[]
w_projectile_ship_turbolaser.dds	Mod	['w_ship_turbolaser_blue1.alo', 'w_ship_turbolaser_blue2.alo', 'w_ship_turbolaser_blue3.alo', 'w_ship_turbolaser_blue4.alo', 'w_ship_turbolaser_blue6.alo', 'w_ship_turbolaser_blue8.alo', 'w_ship_turbolaser_green1.alo', 'w_ship_turbolaser_green2.alo', 'w_ship_turbolaser_green3.alo', 'w_ship_turbolaser_green4.alo', 'w_ship_turbolaser_green6.alo', 'w_ship_turbolaser_green8.alo', 'w_ship_turbolaser_ion1.alo', 'w_ship_turbolaser_ion2.alo', 'w_ship_turbolaser_ion3.alo', 'w_ship_turbolaser_ion3_heavy.alo', 'w_ship_turbolaser_ion4.alo', 'w_ship_turbolaser_ion6.alo', 'w_ship_turbolaser_ion8.alo', 'w_ship_turbolaser_purple1.alo', 'w_ship_turbolaser_purple2.alo', 'w_ship_turbolaser_purple3.alo', 'w_ship_turbolaser_purple4.alo', 'w_ship_turbolaser_purple6.alo', 'w_ship_turbolaser_purple8.alo', 'w_ship_turbolaser_red1.alo', 'w_ship_turbolaser_red2.alo', 'w_ship_turbolaser_red3.alo', 'w_ship_turbolaser_red4.alo', 'w_ship_turbolaser_red6.alo', 'w_ship_turbolaser_red8.alo', 'w_ship_turbolaser_yellow1.alo', 'w_ship_turbolaser_yellow2.alo', 'w_ship_turbolaser_yellow3.alo', 'w_ship_turbolaser_yellow4.alo', 'w_ship_turbolaser_yellow6.alo', 'w_ship_turbolaser_yellow8.alo']
w_sky_snow01.dds	Mod	['w_sky_snow01.alo']
w_spacepropclouds_01.dds	Mod	['w_skirmish_temperate01.alo', 'w_skirmish_temperate02.alo']
w_spacepropclouds_01_b.dds	Mod	['w_skirmish_temperate01.alo', 'w_skirmish_temperate02.alo']
w_spacepropclouds_02.dds	Unused?	[]
w_spacepropclouds_02_b.dds	Unused?	[]
w_spacepropclouds_03.dds	Unused?	[]
w_spacepropclouds_03_b.dds	Unused?	[]
w_spacepropclouds_04.dds	Unused?	[]
w_spacepropclouds_04_b.dds	Unused?	[]
w_spacepropclouds_05.dds	Unused?	[]
w_spacepropclouds_05_b.dds	Unused?	[]
w_spacepropclouds_06.dds	Unused?	[]
w_spacepropclouds_06_b.dds	Unused?	[]
w_spacepropclouds_07.dds	Unused?	[]
w_spacepropclouds_07_b.dds	Unused?	[]
w_spacepropclouds_08.dds	Unused?	[]
w_spacepropclouds_08_b.dds	Unused?	[]
w_spacepropclouds_09.dds	Unused?	[]
w_spacepropclouds_09_b.dds	Unused?	[]
w_spacepropclouds_desert.dds	Unused?	[]
w_spacepropclouds_desert01.dds	Unused?	[]
w_spacepropclouds_desert01_b.dds	Unused?	[]
w_spacepropclouds_desert_b.dds	Unused?	[]
w_spacepropclouds_forest.dds	Unused?	[]
w_spacepropclouds_forest01.dds	Unused?	[]
w_spacepropclouds_forest01_b.dds	Unused?	[]
w_spacepropclouds_forest_b.dds	Unused?	[]
w_spacepropclouds_ice.dds	Unused?	[]
w_spacepropclouds_ice01.dds	Unused?	[]
w_spacepropclouds_ice01_b.dds	Unused?	[]
w_spacepropclouds_ice_b.dds	Unused?	[]
w_spacepropclouds_ocean.dds	Unused?	[]
w_spacepropclouds_ocean_b.dds	Unused?	[]
w_spacepropclouds_swamp.dds	Unused?	[]
w_spacepropclouds_swamp01.dds	Unused?	[]
w_spacepropclouds_swamp01_b.dds	Unused?	[]
w_spacepropclouds_swamp_b.dds	Unused?	[]
w_spacepropclouds_temperate.dds	Unused?	[]
w_spacepropclouds_temperate01.dds	Unused?	[]
w_spacepropclouds_temperate01_b.dds	Unused?	[]
w_spacepropclouds_temperate_b.dds	Unused?	[]
w_spacepropclouds_urban.dds	Unused?	[]
w_spacepropclouds_urban01.dds	Unused?	[]
w_spacepropclouds_urban01_b.dds	Unused?	[]
w_spacepropclouds_urban01_l.dds	Unused?	[]
w_spacepropclouds_urban_b.dds	Unused?	[]
w_spacepropclouds_urban_l.dds	Unused?	[]
w_spacepropclouds_volcanic.dds	Unused?	[]
w_spacepropclouds_volcanic01.dds	Mod	['w_planetprop_temperate.alo', 'w_spaceprop_savann01.alo']
w_spacepropclouds_volcanic01_b.dds	Mod	['w_planetprop_temperate.alo', 'w_spaceprop_savann01.alo']
w_spacepropclouds_volcanic_b.dds	Unused?	[]
w_spaceprop_alderaan.dds	Mod	['w_planetprop_temperate.alo']
w_spaceprop_alderaan_b.dds	Mod	['w_planetprop_temperate.alo']
w_spaceprop_atmosphere.dds	Mod	['w_skirmish_est.alo', 'w_skirmish_temperate01.alo', 'w_skirmish_temperate02.alo']
w_spaceprop_atmosphere.tga	Unused?	[]
w_spaceprop_atmosphere_low.dds	Mod	['empire_star_destroyeri.alo', 'ev_isd1.alo', 'w_skirmish_est.alo', 'w_skirmish_temperate01.alo', 'w_skirmish_temperate02.alo']
w_spaceprop_desert.dds	Unused?	[]
w_spaceprop_desert01.dds	Unused?	[]
w_spaceprop_desert01_b.dds	Unused?	[]
w_spaceprop_desert_b.dds	Unused?	[]
w_spaceprop_forest.dds	Unused?	[]
w_spaceprop_forest01.dds	Unused?	[]
w_spaceprop_forest01_b.dds	Unused?	[]
w_spaceprop_forest_b.dds	Unused?	[]
w_spaceprop_ice.dds	Unused?	[]
w_spaceprop_ice01.dds	Unused?	[]
w_spaceprop_ice01_b.dds	Unused?	[]
w_spaceprop_ice_b.dds	Unused?	[]
w_spaceprop_mixed01.dds	Mod	['spaceprop_mixed01.alo']
w_spaceprop_mixed01_b.dds	Mod	['spaceprop_mixed01.alo']
w_spaceprop_ocean.dds	Unused?	[]
w_spaceprop_ocean_b.dds	Unused?	[]
w_spaceprop_savann01.dds	Mod	['w_spaceprop_savann01.alo']
w_spaceprop_savann01_b.dds	Mod	['w_spaceprop_savann01.alo']
w_spaceprop_swamp.dds	Unused?	[]
w_spaceprop_swamp01.dds	Unused?	[]
w_spaceprop_swamp01_b.dds	Unused?	[]
w_spaceprop_swamp_b.dds	Unused?	[]
w_spaceprop_temperate.dds	Unused?	[]
w_spaceprop_temperate01.dds	Mod	['w_skirmish_est.alo', 'w_skirmish_temperate01.alo']
w_spaceprop_temperate01_b.dds	Mod	['w_skirmish_est.alo', 'w_skirmish_temperate01.alo']
w_spaceprop_temperate01_clouds.dds	Mod	['w_skirmish_est.alo']
w_spaceprop_temperate01_clouds_b.dds	Mod	['w_skirmish_est.alo']
w_spaceprop_temperate02.dds	Mod	['w_skirmish_temperate02.alo']
w_spaceprop_temperate02_b.dds	Mod	['w_skirmish_temperate02.alo']
w_spaceprop_temperate_b.dds	Unused?	[]
w_spaceprop_urban.dds	Unused?	[]
w_spaceprop_urban01.dds	Unused?	[]
w_spaceprop_urban01_b.dds	Unused?	[]
w_spaceprop_urban01_l.dds	Unused?	[]
w_spaceprop_urban_b.dds	Unused?	[]
w_spaceprop_urban_l.dds	Unused?	[]
w_spaceprop_volcanic.dds	Unused?	[]
w_spaceprop_volcanic01.dds	Unused?	[]
w_spaceprop_volcanic01_b.dds	Unused?	[]
w_spaceprop_volcanic01_l.dds	Unused?	[]
w_spaceprop_volcanic_b.dds	Unused?	[]
w_spaceprop_volcanic_l.dds	Unused?	[]
w_starfield01.dds	Mod	['w_primaryskydome01.alo', 'w_universe_skydome01.alo', 'w_universe_skydome_tatooine.alo']
w_starfield01_nebula.dds	Mod	['w_secondarynebula01.alo']
w_starfield02.dds	Mod	['w_universe_skydome02.alo']
w_starfield03.dds	Mod	['w_universe_skydome03.alo']
w_starfield04.dds	Mod	['w_universe_skydome04.alo']
w_starfield05.dds	Mod	['w_universe_skydome05.alo']
w_starfield06.dds	Mod	['w_universe_skydome06.alo']
w_starfield07.dds	Mod	['w_universe_skydome07.alo']
w_starfield08.dds	Mod	['w_universe_skydome08.alo']
w_starfield09.dds	Mod	['w_universe_skydome09.alo']
w_starfield10.dds	Mod	['w_universe_skydome10.alo']
w_starfield11.dds	Mod	['w_universe_skydome11.alo']
w_starfield12.dds	Mod	['w_universe_skydome12.alo']
w_stars_sun00.dds	Mod	['w_primaryskydome01.alo', 'w_sky_snow01.alo', 'w_universe_skydome01.alo', 'w_universe_skydome07.alo', 'w_universe_skydome13.alo', 'w_universe_skydome14.alo', 'w_universe_skydome15.alo', 'w_universe_skydome16.alo', 'w_universe_skydome17.alo', 'w_universe_skydome18.alo', 'w_universe_skydome19.alo', 'w_universe_skydome20.alo', 'w_universe_skydome21.alo', 'w_universe_skydome22.alo', 'w_universe_skydome23.alo', 'w_universe_skydome24.alo']
w_stars_sun01.dds	Mod	['w_universe_skydome02.alo', 'w_universe_skydome08.alo']
w_stars_sun02.dds	Mod	['w_universe_skydome03.alo', 'w_universe_skydome09.alo']
w_stars_sun03.dds	Mod	['w_universe_skydome04.alo', 'w_universe_skydome10.alo']
w_stars_sun04.dds	Mod	['w_universe_skydome05.alo', 'w_universe_skydome11.alo']
w_stars_sun05.dds	Mod	['w_universe_skydome06.alo', 'w_universe_skydome12.alo']
w_stars_sun_tatooine.dds	Mod	['w_universe_skydome_tatooine.alo']
w_te_rock_f_02_b.dds	Mod	['empire_tie_phantom.alo']
w_turbolaser.tga	Unused?	[]
w_turbolaser_flash.dds	Mod	['p_damage_bomber_ground_green.alo', 'p_damage_bomber_ground_red.alo', 'p_damage_ground_large_blue.alo', 'p_damage_ground_large_green.alo', 'p_damage_ground_large_ion.alo', 'p_damage_ground_large_purple.alo', 'p_damage_ground_large_red.alo', 'p_damage_ground_large_yellow.alo', 'p_damage_ground_medium_blue.alo', 'p_damage_ground_medium_green.alo', 'p_damage_ground_medium_ion.alo', 'p_damage_ground_medium_purple.alo', 'p_damage_ground_medium_red.alo', 'p_damage_ground_medium_yellow.alo', 'p_damage_ground_small_blue.alo', 'p_damage_ground_small_green.alo', 'p_damage_ground_small_ion.alo', 'p_damage_ground_small_purple.alo', 'p_damage_ground_small_red.alo', 'p_damage_ground_small_yellow.alo', 'p_damage_turbolaser_ion_medium.alo', 'p_damage_turbolaser_ion_small.alo', 'p_damage_turbolaser_small.alo', 'p_explosion_capital.alo', 'p_explosion_hardpoint_small.alo', 'p_infantry_blaster_b.alo', 'p_infantry_blaster_g.alo', 'p_infantry_blaster_i.alo', 'p_infantry_blaster_p.alo', 'p_infantry_blaster_r.alo', 'p_infantry_blaster_y.alo', 'p_ship_turbolaser_b.alo', 'p_ship_turbolaser_g.alo', 'p_ship_turbolaser_i.alo', 'p_ship_turbolaser_p.alo', 'p_ship_turbolaser_r.alo', 'p_ship_turbolaser_y.alo']
x1_armor.dds	Mod	['imperial_hero_x1.alo']
x1_face.dds	Mod	['imperial_hero_x1.alo']
yellow_thruster.dds	Unused?	[]
w_laser_small.dds	Missing	['ei_shadow_trooper.alo', 'ei_trooper.alo', 'ev_at_dt.alo', 'ev_bike.alo', 'm_i_mando_soldier.alo', 'm_snipertrooper.alo', 'ri_mon_mothma.alo', 'ri_pilot.alo', 'ri_saboteur.alo', 'ri_stormtrooper.alo', 't2-b.alo']
ei_snowtroop_a_diff.dds	Missing	['ei_shocktrooper_snow.alo']
ei_snowtroop_a_norm.dds	Missing	['ei_shocktrooper_snow.alo']
ei_snowtroop_b_diff.dds	Missing	['ei_shocktrooper_snow.alo']
ei_snowtroop_b_norm.dds	Missing	['ei_shocktrooper_snow.alo']
none.dds	Missing	['empire_tie_advanced.alo', 'empire_tie_defender.alo', 'empire_tie_phantom.alo']
ev_tie_advanced_1_diff.dds	Missing	['empire_tie_inquisitor.alo']
ev_tie_advanced_1_n.dds	Missing	['empire_tie_inquisitor.alo']
ev_tie_adv_inq_diff.tga	Missing	['empire_tie_inquisitor.alo']
ev_tie_adv_inq_n.dds	Missing	['empire_tie_inquisitor.alo']
ev_tie_fighter_diff.dds	Missing	['empire_tie_inquisitor.alo']
ev_tie_fighter_n.dds	Missing	['empire_tie_inquisitor.alo']
ewing_emission.dds	Missing	['ev_bellator_star_dreadnought.alo']
kuatiilights.dds	Missing	['ev_bellator_star_dreadnought.alo']
ev_speeder_bike.dds	Missing	['ev_bike.alo']
ev_speeder_bike_n.dds	Missing	['ev_bike.alo']
imphullpanel_base.dds	Missing	['ev_mandatoriii_aculeus.alo']
imphullpanel_normal.dds	Missing	['ev_mandatoriii_aculeus.alo']
velox_hangar.dds	Missing	['ev_mandatoriii_aculeus.alo']
shield_color.dds	Missing	['imperial_i-class_star_destroyer.alo']
imp_tie_bomber.dds	Missing	['imp_tie_bomber.alo']
imp_tie_bomber_n.dds	Missing	['imp_tie_bomber.alo']
imp_tie_e.dds	Missing	['imp_tie_bomber.alo', 'imp_tie_defender.alo', 'imp_tie_fighter.alo', 'imp_tie_interceptor.alo']
imp_tie_defender.dds	Missing	['imp_tie_defender.alo']
imp_tie_defender_n.dds	Missing	['imp_tie_defender.alo']
imp_tie_cockpit.dds	Missing	['imp_tie_defender.alo', 'imp_tie_fighter.alo', 'imp_tie_interceptor.alo']
imp_tie_fighter.dds	Missing	['imp_tie_fighter.alo']
imp_tie_fighter_n.dds	Missing	['imp_tie_fighter.alo']
imp_tie_interceptor.dds	Missing	['imp_tie_interceptor.alo']
imp_tie_interceptor_n.dds	Missing	['imp_tie_interceptor.alo']
i_scan_lines.dds	Missing	['i_galactic_controls.alo', 'i_tactical_controls.alo', 'planetary_mode.alo', 'planetary_mode_overlay.alo']
i_galactic_dashboard_wide_rebel.dds	Missing	['i_galactic_controls.alo']
p_particle_lord.dds	Missing	['pp_concussion_missile_b.alo', 'p_damage_turbolaser_blue_large.alo', 'p_damage_turbolaser_blue_medium.alo', 'p_damage_turbolaser_blue_small.alo', 'p_damage_turbolaser_green_large.alo', 'p_damage_turbolaser_green_medium.alo', 'p_damage_turbolaser_green_small.alo', 'p_damage_turbolaser_purple_large.alo', 'p_damage_turbolaser_purple_medium.alo', 'p_damage_turbolaser_purple_small.alo', 'p_damage_turbolaser_red_large.alo', 'p_damage_turbolaser_red_medium.alo', 'p_damage_turbolaser_red_small.alo', 'p_damage_turbolaser_yellow_large.alo', 'p_damage_turbolaser_yellow_medium.alo', 'p_damage_turbolaser_yellow_small.alo']
p_particle_master.tga	Missing	['p_bomber_hit_large.alo', 'p_damage_turbolaser_medium.alo', 'p_explosion_station.alo', 'p_galaxycore.alo', 'p_xyston_superlaser.alo']
gc_faction_logo.dds	Missing	['p_early_empire_logo.alo', 'p_first_order_logo.alo', 'p_galactic_empire_logo.alo', 'p_hapan_consortium_logo.alo', 'p_hutt_cartel_logo.alo', 'p_mandalorians_logo.alo', 'p_new_republic_logo.alo', 'p_pyke_syndicate_logo.alo', 'p_rebel_alliance_logo.alo', 'p_remnant_adelhard_logo.alo', 'p_remnant_gratloe_logo.alo', 'p_remnant_loring_logo.alo', 'p_remnant_rax_logo.alo', 'p_terrorists_logo.alo']
p_particle_heat_master.tga	Missing	['p_explosion_capital.alo', 'p_explosion_hardpoint_small.alo', 'p_explosion_station.alo']
rv_t2btank.dds	Missing	['t2-b.alo']
rv_t2btank_bump.dds	Missing	['t2-b.alo']
nb_shieldbase.dds	Missing	['t2-b.alo']
w_projectile_infantry_blaster.dds	Missing	['w_infantry_blaster_blue.alo', 'w_infantry_blaster_green.alo', 'w_infantry_blaster_ion.alo', 'w_infantry_blaster_purple.alo', 'w_infantry_blaster_red.alo', 'w_infantry_blaster_yellow.alo']
w_planet_dstar_dish.tga	Missing	['w_planet_deathstar02.alo']
w_planet_dstar_dish_bc.tga	Missing	['w_planet_deathstar02.alo']
w_planet_dstar.tga	Missing	['w_planet_deathstar02.alo']
w_planet_dstar_bc.tga	Missing	['w_planet_deathstar02.alo']
w_skyorange00.dds	Missing	['w_sky_snow01.alo']
w_projectile_torpedo.dds	Missing	['w_torpedo_blue1.alo', 'w_torpedo_green1.alo', 'w_torpedo_ion1.alo', 'w_torpedo_purple1.alo', 'w_torpedo_red1.alo', 'w_torpedo_yellow1.alo']
w_turbolaser.dds	Missing	['w_turbolaser_g.alo', 'w_turbolaser_g2.alo', 'w_turbolaser_g3.alo']
w_starfield13.dds	Missing	['w_universe_skydome13.alo']
w_starfield14.dds	Missing	['w_universe_skydome14.alo']
w_starfield15.dds	Missing	['w_universe_skydome15.alo']
w_starfield16.dds	Missing	['w_universe_skydome16.alo']
w_starfield17.dds	Missing	['w_universe_skydome17.alo']
w_starfield18.dds	Missing	['w_universe_skydome18.alo']
w_starfield19.dds	Missing	['w_universe_skydome19.alo']
w_starfield20.dds	Missing	['w_universe_skydome20.alo']
w_starfield21.dds	Missing	['w_universe_skydome21.alo']
w_starfield22.dds	Missing	['w_universe_skydome22.alo']
w_starfield23.dds	Missing	['w_universe_skydome23.alo']
w_starfield24.dds	Missing	['w_universe_skydome24.alo']
w_projectile_vehicle_turbolaser.dds	Missing	['w_vehicle_turbolaser_blue.alo', 'w_vehicle_turbolaser_green.alo', 'w_vehicle_turbolaser_ion.alo', 'w_vehicle_turbolaser_purple.alo', 'w_vehicle_turbolaser_red.alo', 'w_vehicle_turbolaser_yellow.alo']
