501st_clonetrooper.alo	Mod	['Units_land_early_empire_501st.xml']
anakin_skywalker_dark.alo	Unused?	[]
cis_b1_assault.alo	Mod	['Units_land_BankingClan_plex_droid.xml', 'units_land_commerce_plex_droid.xml', 'units_land_commerce_plex_droid.xml', 'units_land_federation_plex_droid.xml', 'units_land_federation_plex_droid.xml']
cis_b1_battledroid.alo	Mod	['Units_land_BankingClan_battledroid.xml', 'units_land_cis_battledroid.xml', 'units_land_cis_battledroid.xml', 'units_land_commerce_battledroid.xml', 'units_land_commerce_battledroid.xml', 'units_land_technounion_battledroid.xml', 'units_land_technounion_battledroid.xml', 'units_land_federation_battledroid.xml', 'units_land_federation_battledroid.xml']
cis_b1_battledroid_geo_heavy.alo	Unused?	[]
cis_b1_battledroid_grenadier.alo	Mod	['Units_land_BankingClan_Droid_Grenadier.xml', 'units_land_cis_battledroid_grenadier.xml', 'units_land_commerce_battledroid_grenadier.xml', 'units_land_technounion_battledroid_grenadier.xml', 'units_land_federation_droid_grenadier.xml']
cis_b1_battledroid_heavy.alo	Mod	['Units_land_cis_battledroid_heavy.xml', 'units_land_commerce_battledroid_heavy.xml', 'units_land_commerce_battledroid_heavy.xml']
cis_b1_battledroid_oom_pistol.alo	Mod	['Units_land_BankingClan_B1_commander.xml', 'units_land_cis_b1_droid_commander.xml', 'units_land_commerce_droidcommander.xml', 'units_land_commerce_droidcommander.xml', 'units_land_technounion_b1_droid_commander.xml', 'units_land_technounion_b1_droid_commander.xml', 'units_land_federation_b1_droid_commander.xml', 'units_land_federation_b1_droid_commander.xml']
cis_b1_battledroid_specialist.alo	Mod	['Units_land_BankingClan_specialist.xml', 'units_land_cis_battledroid_specialist.xml', 'units_land_cis_battledroid_specialist.xml']
cis_b1_commander_oom.alo	Unused?	[]
cis_b1_heavy.alo	Mod	['Units_land_BankingClan_droid_heavy.xml', 'units_land_technounion_battledroid_heavy.xml', 'units_land_technounion_battledroid_heavy.xml']
cis_b1_heavy_geo.alo	Mod	['Units_land_BankingClan_droids_Sand.xml', 'units_land_cis_battledroids_sand.xml', 'units_land_cis_battledroids_sand.xml', 'units_land_commerce_battledroids_sand.xml', 'units_land_commerce_battledroids_sand.xml', 'units_land_technounion_battledroids_sand.xml', 'units_land_technounion_battledroids_sand.xml', 'units_land_federation_battledroids_sand.xml', 'units_land_federation_battledroids_sand.xml']
cis_b1_specialist.alo	Mod	['Units_land_Commerce_battledroid_specialist.xml', 'units_land_technounion_specialist.xml', 'units_land_technounion_specialist.xml', 'units_land_federation_droid_specialist.xml', 'units_land_federation_droid_specialist.xml']
cis_b2droid.alo	Mod	['Units_land_BankingClan_super_battledroid.xml', 'units_land_cis_super_battledroid.xml', 'units_land_cis_super_battledroid.xml', 'units_land_commerce_super_battledroid.xml', 'units_land_commerce_super_battledroid.xml', 'units_land_technounion_super_battledroid.xml', 'units_land_technounion_super_battledroid.xml', 'units_land_federation_super_battledroid.xml', 'units_land_federation_super_battledroid.xml']
cis_b2_grapple_battledroid.alo	Mod	['Units_land_BankingClan_super_B2_Grapple.xml', 'units_land_cis_super_b2_grapple.xml', 'units_land_federation_super_b2_grapple.xml', 'units_land_federation_super_b2_grapple.xml']
cis_b2_grapple_battledroid_red.alo	Mod	['Units_land_cis_super_B2_Grapple.xml']
cis_b2_ha _battledroid.alo	Mod	['Units_land_Commerce_super_B2_Grapple.xml', 'units_land_technounion_super_b2_grapple.xml', 'units_land_technounion_super_b2_grapple.xml', 'units_land_federation_battledroid_heavy.xml', 'units_land_federation_battledroid_heavy.xml']
cis_bx_commando.alo	Mod	['Units_land_BankingClan_bx_commando.xml', 'units_land_cis_bx_commando.xml', 'units_land_cis_bx_commando.xml', 'units_land_commerce_bx_commando.xml', 'units_land_commerce_bx_commando.xml', 'units_land_technounion_bx_commando.xml', 'units_land_technounion_bx_commando.xml', 'units_land_federation_bx_commando.xml', 'units_land_federation_bx_commando.xml']
cis_bx_commando_captain.alo	Unused?	[]
cis_ig100.alo	Mod	['Units_land_TechnoUnion_ig100.xml']
cis_ig100_blue.alo	Mod	['Units_land_cis_ig100.xml']
cis_recusant_frigate.alo	Unused?	[]
ei_armytrooper.alo	Mod	['Units_land_early_empire_armytrooper.xml']
ei_deathtrooper.alo	Unused?	[]
ei_imperial_clonetrooper.alo	Mod	['Units_land_early_empire_elitetroopers.xml']
ei_imperial_super_commando.alo	Unused?	[]
ei_magmatrooper.alo	Unused?	[]
ei_mudtrooper.alo	Unused?	[]
ei_mustafartrooper.alo	Unused?	[]
ei_novatrooper.alo	Mod	['Units_land_early_empire_Novatroopers.xml']
ei_purgetrooper_commander.alo	Mod	['Units_land_early_empire_purgetroopers.xml']
ei_shadow_trooper.alo	Unused?	[]
ei_shocktrooper.alo	Unused?	[]
ei_shocktrooper_heavy.alo	Mod	['Units_land_early_empire_flametroopers.xml']
ei_shocktrooper_snow.alo	Unused?	[]
ei_shoretrooper.alo	Unused?	[]
ei_thrawn.alo	Unused?	[]
ei_trooper.alo	Mod	['Units_land_CorSec_Stormtrooper.xml', 'units_land_crimson_dawn_trooper.xml', 'units_land_crimson_dawn_trooper.xml', 'units_land_early_empire_stormtrooper.xml', 'units_land_early_empire_stormtrooper.xml', 'units_land_first_order_stormtrooper.xml', 'units_land_first_order_stormtrooper.xml', 'units_land_galactic_empire_stormtrooper.xml', 'units_land_galactic_empire_stormtrooper.xml', 'units_land_hapan_trooper.xml', 'units_land_hapan_trooper.xml', 'units_land_adelhard_stormtrooper.xml', 'units_land_adelhard_stormtrooper.xml', 'units_land_gratloe_stormtrooper.xml', 'units_land_gratloe_stormtrooper.xml', 'units_land_loring_stormtrooper.xml', 'units_land_loring_stormtrooper.xml', 'units_land_rax_stormtrooper.xml', 'units_land_rax_stormtrooper.xml', 'units_land_remnant_thrawn_stormtrooper.xml', 'units_land_remnant_thrawn_stormtrooper.xml', 'units_land_remnant_trooper.xml', 'units_land_remnant_trooper.xml']
ei_trooper_sand.alo	Vanilla	[]
ei_trooper_snow.alo	Vanilla	[]
ei_ubrick_adelhard.alo	Unused?	[]
ei_vader.alo	Vanilla	[]
empire_dominator.alo	Unused?	[]
empire_procursator.alo	Unused?	[]
empire_starbase_level_01.alo	Mod	['Starbases_Empire.xml', 'starbases_banking_clan.xml', 'starbases_black_sun.xml', 'starbases_cis_remnant.xml', 'starbases_commerce_guild.xml', 'starbases_corporate_sector.xml', 'starbases_crimson_dawn.xml', 'starbases_early_empire.xml', 'starbases_first_order.xml', 'starbases_galactic_empire.xml', 'starbases_hapan_consortium.xml', 'starbases_hutt_cartel.xml', 'starbases_imperial_remnant.xml', 'starbases_imperial_remnant_adelhard.xml', 'starbases_imperial_remnant_gratloe.xml', 'starbases_imperial_remnant_loring.xml', 'starbases_imperial_remnant_rax.xml', 'starbases_imperial_remnant_thrawn.xml', 'starbases_mandalorians.xml', 'starbases_new_republic.xml', 'starbases_pyke_syndicate.xml', 'starbases_rebel_alliance.xml', 'starbases_techno_union.xml', 'starbases_terrorists.xml', 'starbases_trade_federation.xml']
empire_starbase_level_02.alo	Mod	['Starbases_Empire.xml', 'starbases_banking_clan.xml', 'starbases_black_sun.xml', 'starbases_cis_remnant.xml', 'starbases_commerce_guild.xml', 'starbases_corporate_sector.xml', 'starbases_crimson_dawn.xml', 'starbases_early_empire.xml', 'starbases_first_order.xml', 'starbases_galactic_empire.xml', 'starbases_hapan_consortium.xml', 'starbases_hutt_cartel.xml', 'starbases_imperial_remnant.xml', 'starbases_imperial_remnant_adelhard.xml', 'starbases_imperial_remnant_gratloe.xml', 'starbases_imperial_remnant_loring.xml', 'starbases_imperial_remnant_rax.xml', 'starbases_imperial_remnant_thrawn.xml', 'starbases_mandalorians.xml', 'starbases_new_republic.xml', 'starbases_pyke_syndicate.xml', 'starbases_rebel_alliance.xml', 'starbases_techno_union.xml', 'starbases_terrorists.xml', 'starbases_trade_federation.xml']
empire_starbase_level_03.alo	Mod	['Starbases_Empire.xml', 'starbases_banking_clan.xml', 'starbases_black_sun.xml', 'starbases_cis_remnant.xml', 'starbases_commerce_guild.xml', 'starbases_corporate_sector.xml', 'starbases_crimson_dawn.xml', 'starbases_early_empire.xml', 'starbases_first_order.xml', 'starbases_galactic_empire.xml', 'starbases_hapan_consortium.xml', 'starbases_hutt_cartel.xml', 'starbases_imperial_remnant.xml', 'starbases_imperial_remnant_adelhard.xml', 'starbases_imperial_remnant_gratloe.xml', 'starbases_imperial_remnant_loring.xml', 'starbases_imperial_remnant_rax.xml', 'starbases_imperial_remnant_thrawn.xml', 'starbases_mandalorians.xml', 'starbases_new_republic.xml', 'starbases_pyke_syndicate.xml', 'starbases_rebel_alliance.xml', 'starbases_techno_union.xml', 'starbases_terrorists.xml', 'starbases_trade_federation.xml']
empire_starbase_level_04.alo	Mod	['Starbases_Empire.xml', 'starbases_banking_clan.xml', 'starbases_black_sun.xml', 'starbases_cis_remnant.xml', 'starbases_commerce_guild.xml', 'starbases_corporate_sector.xml', 'starbases_crimson_dawn.xml', 'starbases_early_empire.xml', 'starbases_first_order.xml', 'starbases_galactic_empire.xml', 'starbases_hapan_consortium.xml', 'starbases_hutt_cartel.xml', 'starbases_imperial_remnant.xml', 'starbases_imperial_remnant_adelhard.xml', 'starbases_imperial_remnant_gratloe.xml', 'starbases_imperial_remnant_loring.xml', 'starbases_imperial_remnant_rax.xml', 'starbases_imperial_remnant_thrawn.xml', 'starbases_mandalorians.xml', 'starbases_new_republic.xml', 'starbases_pyke_syndicate.xml', 'starbases_rebel_alliance.xml', 'starbases_techno_union.xml', 'starbases_terrorists.xml', 'starbases_trade_federation.xml']
empire_starbase_level_05.alo	Mod	['Starbases_Empire.xml', 'starbases_banking_clan.xml', 'starbases_banking_clan.xml', 'starbases_black_sun.xml', 'starbases_black_sun.xml', 'starbases_cis_remnant.xml', 'starbases_cis_remnant.xml', 'starbases_commerce_guild.xml', 'starbases_commerce_guild.xml', 'starbases_corporate_sector.xml', 'starbases_corporate_sector.xml', 'starbases_crimson_dawn.xml', 'starbases_crimson_dawn.xml', 'starbases_early_empire.xml', 'starbases_early_empire.xml', 'starbases_early_empire.xml', 'starbases_first_order.xml', 'starbases_first_order.xml', 'starbases_galactic_empire.xml', 'starbases_galactic_empire.xml', 'starbases_hapan_consortium.xml', 'starbases_hapan_consortium.xml', 'starbases_hutt_cartel.xml', 'starbases_hutt_cartel.xml', 'starbases_imperial_remnant.xml', 'starbases_imperial_remnant.xml', 'starbases_imperial_remnant_adelhard.xml', 'starbases_imperial_remnant_adelhard.xml', 'starbases_imperial_remnant_gratloe.xml', 'starbases_imperial_remnant_gratloe.xml', 'starbases_imperial_remnant_loring.xml', 'starbases_imperial_remnant_loring.xml', 'starbases_imperial_remnant_rax.xml', 'starbases_imperial_remnant_rax.xml', 'starbases_imperial_remnant_thrawn.xml', 'starbases_imperial_remnant_thrawn.xml', 'starbases_mandalorians.xml', 'starbases_mandalorians.xml', 'starbases_new_republic.xml', 'starbases_new_republic.xml', 'starbases_pyke_syndicate.xml', 'starbases_pyke_syndicate.xml', 'starbases_rebel_alliance.xml', 'starbases_rebel_alliance.xml', 'starbases_techno_union.xml', 'starbases_techno_union.xml', 'starbases_terrorists.xml', 'starbases_terrorists.xml', 'starbases_trade_federation.xml', 'starbases_trade_federation.xml']
empire_star_destroyer2.alo	Mod	['Units_space_Empire_Star_Destroyer2.xml']
empire_star_destroyeri.alo	Mod	['Units_space_Empire_Compellor.xml', 'units_space_empire_praetor.xml', 'units_space_empire_star_destroyer.xml']
empire_star_destroyer_allegiance.alo	Unused?	[]
empire_star_destroyer_chimaera.alo	Unused?	[]
empire_tector.alo	Mod	['Units_space_Empire_Tector.xml']
empire_tie_advanced.alo	Unused?	[]
empire_tie_bomber.alo	Unused?	[]
empire_tie_defender.alo	Unused?	[]
empire_tie_fighter.alo	Unused?	[]
empire_tie_inquisitor.alo	Unused?	[]
empire_tie_interceptor.alo	Unused?	[]
empire_tie_interceptor_royal.alo	Unused?	[]
empire_tie_phantom.alo	Unused?	[]
empire_vindicator.alo	Unused?	[]
engine.alo	Unused?	[]
ev_atar.alo	Unused?	[]
ev_at_dt.alo	Unused?	[]
ev_bellator_star_dreadnought.alo	Unused?	[]
ev_bike.alo	Vanilla	[]
ev_executor_star_dreadnaught.alo	Unused?	[]
ev_immobilizer.alo	Unused?	[]
ev_isd1.alo	Unused?	[]
ev_mandatoriii_aculeus.alo	Unused?	[]
ev_quasar.alo	Unused?	[]
ev_tiestriker.alo	Unused?	[]
finalizer_star_destroyer.alo	Unused?	[]
imperial_hero_x1.alo	Mod	['Units_land_Mandalorian_Bountyhunter.xml']
imperial_i-class_star_destroyer.alo	Mod	['Units_space_Empire_Compellor.xml', 'units_space_empire_praetor.xml', 'units_space_empire_star_destroyer.xml', 'units_space_empire_star_destroyer2.xml', 'units_space_empire_tector.xml']
imp_light_cruiser.alo	Unused?	[]
imp_tie_bomber.alo	Unused?	[]
imp_tie_defender.alo	Unused?	[]
imp_tie_fighter.alo	Unused?	[]
imp_tie_interceptor.alo	Unused?	[]
i_galactic_controls.alo	Mod	['Commandbarcomponents.xml']
i_galactic_organize.alo	Mod	['Commandbarcomponents.xml']
i_tactical_controls.alo	Mod	['Commandbarcomponents.xml']
layer_z_dummy.alo	Mod	['LayerZDummy.xml']
mi_deathwatch_light.alo	Mod	['Units_land_Mandalorian_Death_Watch.xml']
mi_death_watch_commander.alo	Mod	['Units_land_Mandalorian_Commander.xml']
mi_death_watch_lieutenant.alo	Mod	['Units_land_Mandalorian_Lieutenant.xml']
mi_rocket_trooper.alo	Mod	['Units_land_Plex_Mandalorians.xml']
mi_supercommando_captain.alo	Mod	['Units_land_Mandalorian_Super_Commando.xml']
munificent.alo	Unused?	[]
m_i_mando_soldier.alo	Mod	['Units_land_Mandalorian_mandalorianinf.xml']
m_snipertrooper.alo	Mod	['Units_land_Mandalorian_Snipers.xml']
ni_duro.alo	Mod	['Units_land_Terrorist_Duro_Soldier.xml']
ni_duro_2.alo	Unused?	[]
ni_ithorian.alo	Unused?	[]
ni_ithorian_2.alo	Unused?	[]
ni_ithorian_3.alo	Unused?	[]
ni_ithorian_4.alo	Unused?	[]
ni_saw_gerrera.alo	Mod	['Units_hero_Terrorists_Saw_Gerrera.xml']
ni_selkath.alo	Mod	['Units_land_Terrorist_Selkath.xml']
pe_imperial_star_destroyer_large.alo	Mod	['empire_dominator.alo', 'empire_star_destroyer2.alo', 'empire_star_destroyeri.alo', 'empire_tector.alo', 'empire_vindicator.alo', 'engine.alo', 'ev_isd1.alo']
planetary_mode.alo	Mod	['Commandbarcomponents.xml']
planetary_mode_overlay.alo	Mod	['Commandbarcomponents.xml']
pp_concussion_missile_b.alo	Unused?	[]
p_allied_banking_clan.alo	Mod	['Particles.xml']
p_allied_cis_remnant.alo	Mod	['Particles.xml']
p_allied_early_empire.alo	Mod	['Particles.xml']
p_allied_terrorists.alo	Mod	['Particles.xml']
p_allied_trade_federation.alo	Mod	['Particles.xml']
p_bomber_hit_large.alo	Mod	['Particles.xml']
p_damage_bomber_ground_green.alo	Mod	['Particles.xml']
p_damage_bomber_ground_red.alo	Mod	['Particles.xml']
p_damage_ground_large_blue.alo	Mod	['Particles.xml']
p_damage_ground_large_green.alo	Mod	['Particles.xml']
p_damage_ground_large_ion.alo	Mod	['Particles.xml']
p_damage_ground_large_purple.alo	Mod	['Particles.xml']
p_damage_ground_large_red.alo	Mod	['Particles.xml']
p_damage_ground_large_yellow.alo	Mod	['Particles.xml']
p_damage_ground_medium_blue.alo	Mod	['Particles.xml']
p_damage_ground_medium_green.alo	Mod	['Particles.xml']
p_damage_ground_medium_ion.alo	Mod	['Particles.xml']
p_damage_ground_medium_purple.alo	Mod	['Particles.xml']
p_damage_ground_medium_red.alo	Mod	['Particles.xml']
p_damage_ground_medium_yellow.alo	Mod	['Particles.xml']
p_damage_ground_small_blue.alo	Mod	['Particles.xml']
p_damage_ground_small_green.alo	Mod	['Particles.xml']
p_damage_ground_small_ion.alo	Mod	['Particles.xml']
p_damage_ground_small_purple.alo	Mod	['Particles.xml']
p_damage_ground_small_red.alo	Mod	['Particles.xml']
p_damage_ground_small_yellow.alo	Mod	['Particles.xml']
p_damage_turbolaser_blue_large.alo	Mod	['Particles.xml']
p_damage_turbolaser_blue_medium.alo	Mod	['Particles.xml']
p_damage_turbolaser_blue_small.alo	Mod	['Particles.xml']
p_damage_turbolaser_green_large.alo	Mod	['Particles.xml']
p_damage_turbolaser_green_medium.alo	Mod	['Particles.xml']
p_damage_turbolaser_green_small.alo	Mod	['Particles.xml']
p_damage_turbolaser_ion_medium.alo	Mod	['Particles.xml']
p_damage_turbolaser_ion_small.alo	Mod	['Particles.xml']
p_damage_turbolaser_medium.alo	Unused?	[]
p_damage_turbolaser_purple_large.alo	Mod	['Particles.xml']
p_damage_turbolaser_purple_medium.alo	Mod	['Particles.xml']
p_damage_turbolaser_purple_small.alo	Mod	['Particles.xml']
p_damage_turbolaser_red_large.alo	Mod	['Particles.xml']
p_damage_turbolaser_red_medium.alo	Mod	['Particles.xml']
p_damage_turbolaser_red_small.alo	Mod	['Particles.xml']
p_damage_turbolaser_small.alo	Unused?	[]
p_damage_turbolaser_yellow_large.alo	Mod	['Particles.xml']
p_damage_turbolaser_yellow_medium.alo	Mod	['Particles.xml']
p_damage_turbolaser_yellow_small.alo	Mod	['Particles.xml']
p_early_empire_logo.alo	Unused?	[]
p_explosion_capital.alo	Mod	['Particles.xml']
p_explosion_corvette.alo	Mod	['Particles.xml']
p_explosion_cruiser.alo	Mod	['Particles.xml']
p_explosion_hardpoint.alo	Unused?	[]
p_explosion_hardpoint_small.alo	Unused?	[]
p_explosion_hardpoint_starbase.alo	Mod	['Particles.xml']
p_explosion_station.alo	Mod	['Particles.xml']
p_first_order_logo.alo	Unused?	[]
p_galactic_empire_logo.alo	Unused?	[]
p_galaxycore.alo	Mod	['w_galaxy00.alo']
p_hapan_consortium_logo.alo	Unused?	[]
p_hutt_cartel_logo.alo	Unused?	[]
p_infantry_blaster_b.alo	Unused?	[]
p_infantry_blaster_g.alo	Unused?	[]
p_infantry_blaster_i.alo	Unused?	[]
p_infantry_blaster_p.alo	Unused?	[]
p_infantry_blaster_r.alo	Unused?	[]
p_infantry_blaster_y.alo	Unused?	[]
p_mandalorians_logo.alo	Unused?	[]
p_nebula.alo	Unused?	[]
p_new_republic_logo.alo	Unused?	[]
p_pyke_syndicate_logo.alo	Unused?	[]
p_rebel_alliance_logo.alo	Unused?	[]
p_remnant_adelhard_logo.alo	Unused?	[]
p_remnant_gratloe_logo.alo	Unused?	[]
p_remnant_loring_logo.alo	Unused?	[]
p_remnant_rax_logo.alo	Unused?	[]
p_shield_hit_large.alo	Mod	['Particles.xml']
p_ship_turbolaser_b.alo	Unused?	[]
p_ship_turbolaser_g.alo	Unused?	[]
p_ship_turbolaser_i.alo	Unused?	[]
p_ship_turbolaser_p.alo	Unused?	[]
p_ship_turbolaser_r.alo	Unused?	[]
p_ship_turbolaser_y.alo	Unused?	[]
p_terrorists_logo.alo	Unused?	[]
p_xyston_superlaser.alo	Mod	['Projectiles_Space.xml']
rebel_guard_trooper.alo	Unused?	[]
rep_arctrooper_p2.alo	Mod	['Units_land_Mandalorian_Arc_Commando.xml', 'units_land_mandalorian_bountyhunter.xml']
rep_clonetrooper_p2_basic.alo	Mod	['Units_land_early_empire_clonetroopers.xml']
rep_clonetrooper_p2_heavy.alo	Mod	['Units_land_early_empire_heavytrooper.xml']
rep_commando.alo	Mod	['Units_land_early_empire_commando.xml']
resi_b1_battledroid.alo	Mod	['Units_land_cis_B1_droid_commander.xml']
ri_commando.alo	Unused?	[]
ri_dyn_jarren_the_mandalorian.alo	Mod	['Units_land_Mandalorian_Smuggler.xml']
ri_grenadier.alo	Mod	['Units_land_Terrorist_Grenadier.xml']
ri_light_elite.alo	Unused?	[]
ri_mon_mothma.alo	Mod	['Units_hero_New_Republic_Mon_Mothma.xml']
ri_pilot.alo	Vanilla	[]
ri_rebel_jedi_ahsoka_tano.alo	Unused?	[]
ri_rebel_sniper_snow.alo	Unused?	[]
ri_rebel_sniper_urban.alo	Mod	['Units_land_Terrorist_Sniper.xml']
ri_saboteur.alo	Mod	['Units_land_Terrorist_Saboteur.xml']
ri_skywalker.alo	Vanilla	[]
ri_stormtrooper.alo	Mod	['Units_Land_Terrorist_RiflemanV2.xml']
ri_stormtrooper_v3.alo	Mod	['Units_Land_Terrorist_Rifleman.xml']
ri_trooper_forest_human.alo	Unused?	[]
ri_trooper_forest_twilek.alo	Mod	['Units_land_Black_Sun_Twilek_Forest.xml']
ri_trooper_plex_forest.alo	Unused?	[]
ri_trooper_plex_sand.alo	Mod	['Units_land_Hutts_Sand_Plex_Trooper.xml']
ri_trooper_plex_snow.alo	Unused?	[]
ri_trooper_plex_urban.alo	Unused?	[]
ri_trooper_sand_human3.alo	Mod	['Units_land_Black_Sun_Sand_Trooper.xml', 'units_land_hutts_sand_trooper.xml', 'units_land_hutts_sand_trooper.xml']
ri_trooper_sand_twilek.alo	Mod	['Units_land_Black_Sun_Twilek_Sand.xml', 'units_land_hutts_twilek_sand.xml', 'units_land_hutts_twilek_sand.xml']
ri_trooper_snow_human.alo	Unused?	[]
ri_trooper_snow_human3.alo	Unused?	[]
ri_trooper_snow_twilek.alo	Mod	['Units_land_Black_Sun_Twilek_Snow.xml']
ri_trooper_urban_aqualish.alo	Mod	['Units_land_Black_Sun_Aqualish_Bounty.xml', 'units_land_black_sun_twilek_trooper.xml', 'units_land_hutts_aqualish_bounty.xml', 'units_land_hutts_aqualish_bounty.xml', 'units_land_hutts_twilek_trooper.xml', 'units_land_hutts_twilek_trooper.xml']
ri_trooper_urban_female2.alo	Mod	['Units_land_Terrorist_Vanguard_Trooper.xml']
ri_trooper_urban_human.alo	Mod	['Units_land_Pyke_Syndicate_Trooper.xml']
ri_trooper_urban_ishitib3.alo	Mod	['Units_land_Hutts_Ishitib_Trooper.xml']
ri_trooper_urban_mirialan.alo	Mod	['Units_land_Black_Sun_Mirialan_Trooper.xml']
ri_trooper_urban_quarren2.alo	Mod	['Units_land_Terrorist_Quarren_Bounty.xml']
ri_trooper_urban_quarren3.alo	Mod	['Units_land_Hutts_Quarren_Bounty3.xml']
ri_trooper_urban_rodian.alo	Mod	['Units_land_Black_Sun_Rodian_Bounty.xml']
ri_trooper_urban_rodian2.alo	Mod	['Units_land_Terrorist_Rodian_Bounty.xml']
ri_trooper_urban_rodian3.alo	Mod	['Units_land_Black_Sun_Rodian_Bounty2.xml', 'units_land_hutts_rodian_bounty2.xml', 'units_land_hutts_rodian_bounty2.xml']
ri_trooper_urban_twilek.alo	Mod	['Units_land_Black_Sun_Twilek_Trooper.xml']
rv_snowspeeder.alo	Vanilla	[]
spaceprop_mixed01.alo	Unused?	[]
t2-b.alo	Unused?	[]
tector.alo	Unused?	[]
vindicator.alo	Unused?	[]
w_fighter_turbolaser_g.alo	Mod	['Projectiles_Space.xml']
w_galaxy00.alo	Mod	['Planets.xml', 'planets2.xml']
w_infantry_blaster_blue.alo	Mod	['Projectiles_Land.xml']
w_infantry_blaster_green.alo	Mod	['Projectiles_Land.xml']
w_infantry_blaster_ion.alo	Unused?	[]
w_infantry_blaster_purple.alo	Unused?	[]
w_infantry_blaster_red.alo	Mod	['Projectiles_Land.xml']
w_infantry_blaster_yellow.alo	Mod	['Projectiles_Land.xml']
w_nebula03.alo	Vanilla	[]
w_planetgc_alarisprime.alo	Unused?	[]
w_planetgc_alderaan.alo	Unused?	[]
w_planetgc_antar.alo	Mod	['Planets.xml']
w_planetgc_archipelago01.alo	Mod	['Planets.xml']
w_planetgc_archipelago02.alo	Mod	['Planets.xml']
w_planetgc_archipelago03.alo	Mod	['Planets.xml']
w_planetgc_archipelago04.alo	Mod	['Planets.xml']
w_planetgc_bespin.alo	Mod	['Planets.xml']
w_planetgc_christophsis.alo	Unused?	[]
w_planetgc_coruscant.alo	Mod	['Planets.xml']
w_planetgc_desert.alo	Unused?	[]
w_planetgc_desert01.alo	Mod	['Planets.xml']
w_planetgc_desert02.alo	Mod	['Planets.xml']
w_planetgc_desert03.alo	Mod	['Planets.xml']
w_planetgc_desert04.alo	Mod	['Planets.xml']
w_planetgc_endor.alo	Mod	['Planets.xml']
w_planetgc_exogol.alo	Unused?	[]
w_planetgc_forest.alo	Unused?	[]
w_planetgc_forest01.alo	Mod	['Planets.xml']
w_planetgc_forest02.alo	Mod	['Planets.xml']
w_planetgc_forest03.alo	Mod	['Planets.xml']
w_planetgc_forest04.alo	Mod	['Planets.xml']
w_planetgc_ice.alo	Unused?	[]
w_planetgc_ice01.alo	Mod	['Planets.xml']
w_planetgc_ice02.alo	Mod	['Planets.xml']
w_planetgc_ice03.alo	Mod	['Planets.xml']
w_planetgc_ice04.alo	Mod	['Planets.xml']
w_planetgc_jedha.alo	Mod	['Planets.xml']
w_planetgc_jungle01.alo	Mod	['Planets.xml']
w_planetgc_jungle02.alo	Mod	['Planets.xml']
w_planetgc_jungle03.alo	Mod	['Planets.xml']
w_planetgc_jungle04.alo	Mod	['Planets.xml']
w_planetgc_kijimi.alo	Unused?	[]
w_planetgc_kuat.alo	Mod	['Planets.xml']
w_planetgc_mixed01.alo	Unused?	[]
w_planetgc_mixed02.alo	Unused?	[]
w_planetgc_mixed03.alo	Unused?	[]
w_planetgc_mixed04.alo	Unused?	[]
w_planetgc_mountain01.alo	Mod	['Planets.xml']
w_planetgc_mountain02.alo	Mod	['Planets.xml']
w_planetgc_mountain03.alo	Mod	['Planets.xml']
w_planetgc_mountain04.alo	Mod	['Planets.xml']
w_planetgc_mountain_temperate01.alo	Mod	['Planets.xml']
w_planetgc_mountain_temperate02.alo	Mod	['Planets.xml']
w_planetgc_mountain_temperate03.alo	Mod	['Planets.xml']
w_planetgc_mountain_temperate04.alo	Mod	['Planets.xml']
w_planetgc_mustafar.alo	Mod	['Planets.xml']
w_planetgc_nallhutta.alo	Mod	['Planets.xml']
w_planetgc_ocean.alo	Unused?	[]
w_planetgc_peridea.alo	Mod	['Planets.xml']
w_planetgc_savann01.alo	Mod	['Planets.xml']
w_planetgc_savann02.alo	Mod	['Planets.xml']
w_planetgc_savann03.alo	Mod	['Planets.xml']
w_planetgc_savann04.alo	Mod	['Planets.xml']
w_planetgc_seatos.alo	Mod	['Planets.xml']
w_planetgc_steppen01.alo	Mod	['Planets.xml']
w_planetgc_steppen02.alo	Mod	['Planets.xml']
w_planetgc_steppen03.alo	Mod	['Planets.xml']
w_planetgc_steppen04.alo	Mod	['Planets.xml']
w_planetgc_swamp.alo	Unused?	[]
w_planetgc_swamp01.alo	Mod	['Planets.xml']
w_planetgc_swamp02.alo	Mod	['Planets.xml']
w_planetgc_swamp03.alo	Mod	['Planets.xml']
w_planetgc_swamp04.alo	Mod	['Planets.xml']
w_planetgc_taiga01.alo	Mod	['Planets.xml']
w_planetgc_taiga02.alo	Mod	['Planets.xml']
w_planetgc_taiga03.alo	Mod	['Planets.xml']
w_planetgc_taiga04.alo	Mod	['Planets.xml']
w_planetgc_telos.alo	Unused?	[]
w_planetgc_temperate.alo	Unused?	[]
w_planetgc_temperate01.alo	Mod	['Planets.xml']
w_planetgc_temperate02.alo	Mod	['Planets.xml']
w_planetgc_temperate03.alo	Mod	['Planets.xml']
w_planetgc_temperate04.alo	Mod	['Planets.xml']
w_planetgc_tundra01.alo	Mod	['Planets.xml']
w_planetgc_tundra02.alo	Mod	['Planets.xml']
w_planetgc_tundra03.alo	Mod	['Planets.xml']
w_planetgc_tundra04.alo	Mod	['Planets.xml']
w_planetgc_urban.alo	Unused?	[]
w_planetgc_urban01.alo	Mod	['Planets.xml']
w_planetgc_urban02.alo	Mod	['Planets.xml']
w_planetgc_urban03.alo	Mod	['Planets.xml']
w_planetgc_urban04.alo	Mod	['Planets.xml']
w_planetgc_volcanic.alo	Unused?	[]
w_planetgc_volcanic01.alo	Mod	['Planets.xml']
w_planetgc_volcanic02.alo	Mod	['Planets.xml']
w_planetgc_volcanic03.alo	Mod	['Planets.xml']
w_planetgc_volcanic04.alo	Mod	['Planets.xml']
w_planetgc_yavin4.alo	Mod	['Planets.xml']
w_planetprop_temperate.alo	Unused?	[]
w_planet_deathstar02.alo	Vanilla	[]
w_planet_select.alo	Unused?	[]
w_planet_select_empire.alo	Unused?	[]
w_planet_select_neutral.alo	Unused?	[]
w_planet_select_pirate.alo	Unused?	[]
w_planet_select_rebel.alo	Unused?	[]
w_primaryskydome01.alo	Mod	['Spaceprimaryskydomes_R.O.T.E.xml']
w_projectile_concussion_missile_b.alo	Mod	['Projectiles_Land.xml']
w_proj_infantry_y.alo	Mod	['Projectiles_Land.xml']
w_secondarynebula01.alo	Mod	['Spacesecondarynebulaes_R.O.T.E.xml']
w_ship_turbolaser_blue1.alo	Mod	['Projectiles_Space.xml']
w_ship_turbolaser_blue2.alo	Mod	['Projectiles_Space.xml']
w_ship_turbolaser_blue3.alo	Mod	['Projectiles_Space.xml']
w_ship_turbolaser_blue4.alo	Mod	['Projectiles_Space.xml']
w_ship_turbolaser_blue6.alo	Unused?	[]
w_ship_turbolaser_blue8.alo	Mod	['Projectiles_Space.xml']
w_ship_turbolaser_green1.alo	Mod	['Projectiles_Space.xml']
w_ship_turbolaser_green2.alo	Mod	['Projectiles_Space.xml']
w_ship_turbolaser_green3.alo	Mod	['Projectiles_Space.xml']
w_ship_turbolaser_green4.alo	Mod	['Projectiles_Space.xml']
w_ship_turbolaser_green6.alo	Mod	['Projectiles_Space.xml']
w_ship_turbolaser_green8.alo	Mod	['Projectiles_Space.xml']
w_ship_turbolaser_ion1.alo	Mod	['Projectiles_Space.xml']
w_ship_turbolaser_ion2.alo	Mod	['Projectiles_Space.xml']
w_ship_turbolaser_ion3.alo	Mod	['Projectiles_Space.xml']
w_ship_turbolaser_ion3_heavy.alo	Mod	['Projectiles_Space.xml']
w_ship_turbolaser_ion4.alo	Mod	['Projectiles_Space.xml']
w_ship_turbolaser_ion6.alo	Mod	['Projectiles_Space.xml']
w_ship_turbolaser_ion8.alo	Mod	['Projectiles_Space.xml']
w_ship_turbolaser_purple1.alo	Mod	['Projectiles_Space.xml']
w_ship_turbolaser_purple2.alo	Mod	['Projectiles_Space.xml']
w_ship_turbolaser_purple3.alo	Mod	['Projectiles_Space.xml']
w_ship_turbolaser_purple4.alo	Mod	['Projectiles_Space.xml']
w_ship_turbolaser_purple6.alo	Mod	['Projectiles_Space.xml']
w_ship_turbolaser_purple8.alo	Mod	['Projectiles_Space.xml']
w_ship_turbolaser_red1.alo	Mod	['Projectiles_Space.xml']
w_ship_turbolaser_red2.alo	Mod	['Projectiles_Space.xml']
w_ship_turbolaser_red3.alo	Mod	['Projectiles_Space.xml']
w_ship_turbolaser_red4.alo	Mod	['Projectiles_Space.xml']
w_ship_turbolaser_red6.alo	Mod	['Projectiles_Space.xml']
w_ship_turbolaser_red8.alo	Mod	['Projectiles_Space.xml']
w_ship_turbolaser_yellow1.alo	Mod	['Projectiles_Space.xml']
w_ship_turbolaser_yellow2.alo	Mod	['Projectiles_Space.xml']
w_ship_turbolaser_yellow3.alo	Mod	['Projectiles_Space.xml']
w_ship_turbolaser_yellow4.alo	Mod	['Projectiles_Space.xml']
w_ship_turbolaser_yellow6.alo	Mod	['Projectiles_Space.xml']
w_ship_turbolaser_yellow8.alo	Mod	['Projectiles_Space.xml']
w_skirmish_est.alo	Unused?	[]
w_skirmish_temperate01.alo	Mod	['Spaceprops_R.O.T.E.xml']
w_skirmish_temperate02.alo	Unused?	[]
w_skydome_nebula_exogol.alo	Unused?	[]
w_skydome_nebula_pirpleblue.alo	Unused?	[]
w_sky_snow01.alo	Unused?	[]
w_spaceprop_savann01.alo	Unused?	[]
w_torpedo_blue1.alo	Unused?	[]
w_torpedo_green1.alo	Unused?	[]
w_torpedo_ion1.alo	Unused?	[]
w_torpedo_purple1.alo	Unused?	[]
w_torpedo_red1.alo	Unused?	[]
w_torpedo_yellow1.alo	Unused?	[]
w_turbolaser_g.alo	Unused?	[]
w_turbolaser_g2.alo	Unused?	[]
w_turbolaser_g3.alo	Unused?	[]
w_universe_skydome01.alo	Unused?	[]
w_universe_skydome02.alo	Mod	['Spaceprimaryskydomes_R.O.T.E.xml', 'spacesecondarynebulaes_r.o.t.e.xml']
w_universe_skydome03.alo	Mod	['Spaceprimaryskydomes_R.O.T.E.xml', 'spacesecondarynebulaes_r.o.t.e.xml']
w_universe_skydome04.alo	Mod	['Spaceprimaryskydomes_R.O.T.E.xml', 'spacesecondarynebulaes_r.o.t.e.xml']
w_universe_skydome05.alo	Mod	['Spaceprimaryskydomes_R.O.T.E.xml', 'spacesecondarynebulaes_r.o.t.e.xml']
w_universe_skydome06.alo	Mod	['Spaceprimaryskydomes_R.O.T.E.xml', 'spacesecondarynebulaes_r.o.t.e.xml']
w_universe_skydome07.alo	Mod	['Spaceprimaryskydomes_R.O.T.E.xml', 'spacesecondarynebulaes_r.o.t.e.xml']
w_universe_skydome08.alo	Mod	['Spaceprimaryskydomes_R.O.T.E.xml', 'spacesecondarynebulaes_r.o.t.e.xml']
w_universe_skydome09.alo	Mod	['Spaceprimaryskydomes_R.O.T.E.xml', 'spacesecondarynebulaes_r.o.t.e.xml']
w_universe_skydome10.alo	Mod	['Spaceprimaryskydomes_R.O.T.E.xml', 'spacesecondarynebulaes_r.o.t.e.xml']
w_universe_skydome11.alo	Mod	['Spaceprimaryskydomes_R.O.T.E.xml', 'spacesecondarynebulaes_r.o.t.e.xml']
w_universe_skydome12.alo	Mod	['Spaceprimaryskydomes_R.O.T.E.xml', 'spacesecondarynebulaes_r.o.t.e.xml']
w_universe_skydome13.alo	Unused?	[]
w_universe_skydome14.alo	Unused?	[]
w_universe_skydome15.alo	Unused?	[]
w_universe_skydome16.alo	Unused?	[]
w_universe_skydome17.alo	Unused?	[]
w_universe_skydome18.alo	Unused?	[]
w_universe_skydome19.alo	Unused?	[]
w_universe_skydome20.alo	Unused?	[]
w_universe_skydome21.alo	Unused?	[]
w_universe_skydome22.alo	Unused?	[]
w_universe_skydome23.alo	Unused?	[]
w_universe_skydome24.alo	Unused?	[]
w_universe_skydome_tatooine.alo	Unused?	[]
w_vehicle_turbolaser_blue.alo	Unused?	[]
w_vehicle_turbolaser_green.alo	Mod	['Projectiles_Land.xml']
w_vehicle_turbolaser_ion.alo	Unused?	[]
w_vehicle_turbolaser_purple.alo	Unused?	[]
w_vehicle_turbolaser_red.alo	Mod	['Projectiles_Land.xml']
w_vehicle_turbolaser_yellow.alo	Mod	['Projectiles_Land.xml']
i_build_buttons.alo	Missing	['Commandbarcomponents.xml']
i_attack_mode_choice.alo	Missing	['Commandbarcomponents.xml']
i_resolve_mode.alo	Missing	['Commandbarcomponents.xml']
i_main_hero_frame_rebel.alo	Missing	['Commandbarcomponents.xml']
i_main_hero_frame_empire.alo	Missing	['Commandbarcomponents.xml']
i_attack_mode.alo	Missing	['Commandbarcomponents.xml']
i_attack_mode_single.alo	Missing	['Commandbarcomponents.xml']
w_flag_marker.alo	Missing	['Company_Spawner.xml']
w_laser_invisible.alo	Missing	['Company_Spawner.xml', 'layerzdummy.xml', 'layerzdummy.xml', 'projectiles.xml', 'projectiles.xml', 'projectiles.xml', 'projectiles.xml', 'projectiles.xml', 'projectiles.xml', 'projectiles.xml', 'projectiles.xml', 'projectiles.xml', 'projectiles.xml', 'projectiles.xml', 'projectiles.xml', 'projectiles.xml', 'projectiles.xml', 'projectiles.xml', 'projectiles.xml', 'projectiles.xml', 'projectiles.xml', 'projectiles.xml']
w_waypoint_beacon.alo	Missing	['Gameconstants.xml']
rb_acc_l01.alo	Missing	['Groundbases.xml']
rb_acc_l02.alo	Missing	['Groundbases.xml']
rb_acc_l03.alo	Missing	['Groundbases.xml']
rb_acc_l04.alo	Missing	['Groundbases.xml']
rb_acc_l05.alo	Missing	['Groundbases.xml']
rv_corvette.alo	Missing	['Hutt_faction_units.xml']
rv_missile_ship.alo	Missing	['Hutt_faction_units.xml']
nv_vwing.alo	Missing	['Hutt_faction_units.xml']
nv_jedicruiser.alo	Missing	['Hutt_faction_units.xml']
nb_apbase.alo	Missing	['Hutt_faction_units.xml']
i_pirate_station.alo	Missing	['Hutt_faction_units.xml']
nv_pskiff.alo	Missing	['Hutt_faction_units.xml']
nv_swampspeeder_p.alo	Missing	['Hutt_faction_units.xml']
ni_hutt.alo	Missing	['Hutt_faction_units.xml', 'units_hero_hutt_cartel_jabba_the_hutt.xml']
ni_twilek_f.alo	Missing	['Hutt_faction_units.xml']
nb_baseshieldgen.alo	Missing	['Hutt_faction_units.xml', 'markers.xml', 'specialstructures.xml', 'specialstructures.xml', 'specialstructures_banking_clan.xml', 'specialstructures_black_sun.xml', 'specialstructures_cis_remnant.xml', 'specialstructures_commerce_guild.xml', 'specialstructures_corporate_sector.xml', 'specialstructures_crimson_dawn.xml', 'specialstructures_early_empire.xml', 'specialstructures_first_order.xml', 'specialstructures_galactic_empire.xml', 'specialstructures_hapan_consortium.xml', 'specialstructures_hutt_cartel.xml', 'specialstructures_imperial_remnant.xml', 'specialstructures_mandalorians.xml', 'specialstructures_new_republic.xml', 'specialstructures_pyke_syndicate.xml', 'specialstructures_rebel_alliance.xml', 'specialstructures_remnant_adelhard.xml', 'specialstructures_remnant_gratloe.xml', 'specialstructures_remnant_loring.xml', 'specialstructures_remnant_rax.xml', 'specialstructures_remnant_thrawn.xml', 'specialstructures_techno_union.xml', 'specialstructures_terrorists.xml', 'specialstructures_trade_federation.xml']
w_flag_marker_green.alo	Missing	['Markers.xml']
w_flag_marker_blue.alo	Missing	['Markers.xml']
nb_baseshieldgen_small.alo	Missing	['Markers.xml', 'specialstructures.xml', 'specialstructures.xml', 'specialstructures.xml', 'specialstructures.xml', 'specialstructures_banking_clan.xml', 'specialstructures_black_sun.xml', 'specialstructures_cis_remnant.xml', 'specialstructures_commerce_guild.xml', 'specialstructures_corporate_sector.xml', 'specialstructures_crimson_dawn.xml', 'specialstructures_early_empire.xml', 'specialstructures_first_order.xml', 'specialstructures_galactic_empire.xml', 'specialstructures_hapan_consortium.xml', 'specialstructures_hutt_cartel.xml', 'specialstructures_imperial_remnant.xml', 'specialstructures_mandalorians.xml', 'specialstructures_new_republic.xml', 'specialstructures_pyke_syndicate.xml', 'specialstructures_rebel_alliance.xml', 'specialstructures_remnant_adelhard.xml', 'specialstructures_remnant_gratloe.xml', 'specialstructures_remnant_loring.xml', 'specialstructures_remnant_rax.xml', 'specialstructures_remnant_thrawn.xml', 'specialstructures_techno_union.xml', 'specialstructures_terrorists.xml', 'specialstructures_trade_federation.xml']
eb_tltower.alo	Missing	['Markers.xml', 'specialstructures.xml', 'specialstructures.xml']
nb_piratebase_01.alo	Missing	['Markers.xml', 'specialstructures.xml']
nv_lrs.alo	Missing	['Markers.xml', 'specialstructures.xml', 'specialstructures.xml', 'specialstructures.xml', 'specialstructures.xml', 'specialstructures.xml']
rb_station_05.alo	Missing	['Markers.xml']
w_flag_marker_white.alo	Missing	['Markers.xml']
w_flag_marker_yellow.alo	Missing	['Markers.xml']
w_flag_marker_red.alo	Missing	['Markers.xml']
w_planet_deathstar.alo	Missing	['Markers.xml']
w_flag_marker_purple.alo	Missing	['Markers.xml']
p_allied_techno_union.alo	Missing	['Particles.xml']
p_damage_turbolaser_ion_large.alo	Missing	['Particles.xml']
p_mouse_click.alo	Missing	['Particles.xml']
p_mouse_double_click.alo	Missing	['Particles.xml']
p_mouse_click_attack.alo	Missing	['Particles.xml']
p_mouse_guard.alo	Missing	['Particles.xml']
p_shield_penetration_generic.alo	Missing	['Particles.xml']
p_dirt_emitter_test1.alo	Missing	['Particles.xml']
p_lava_bubbles.alo	Missing	['Particles.xml']
p_hover_generic.alo	Missing	['Particles.xml']
p_steam_small01.alo	Missing	['Particles.xml']
p_explosion_small00.alo	Missing	['Particles.xml']
p_explosion_empire_small00.alo	Missing	['Particles.xml']
p_explosion_med00.alo	Missing	['Particles.xml']
p_explosion_empire_med00.alo	Missing	['Particles.xml']
p_explosion_big00.alo	Missing	['Particles.xml']
p_explosion_empire_big00.alo	Missing	['Particles.xml']
p_explosion_huge00.alo	Missing	['Particles.xml']
p_explosion_friggin_huge00.alo	Missing	['Particles.xml']
p_explosion_empire_friggin_huge00.alo	Missing	['Particles.xml']
p_explosion_empire_huge00.alo	Missing	['Particles.xml']
p_explosion_empire_huge00_no_debris.alo	Missing	['Particles.xml']
p_explosion_small01.alo	Missing	['Particles.xml']
p_explosion_missile_ground01.alo	Missing	['Particles.xml']
p_explosion_thermal_empire.alo	Missing	['Particles.xml']
p_explosion_thermal_rebel.alo	Missing	['Particles.xml']
p_seismic_explosion00.alo	Missing	['Particles.xml']
p_explosion_big01.alo	Missing	['Particles.xml']
p_explosion_atat01.alo	Missing	['Particles.xml']
p_explosion_huge01.alo	Missing	['Particles.xml']
p_damage_small00.alo	Missing	['Particles.xml']
p_damage_med00.alo	Missing	['Particles.xml']
p_damage_big00.alo	Missing	['Particles.xml']
p_spmat_splash.alo	Missing	['Particles.xml']
p_self_destruct_effect.alo	Missing	['Particles.xml']
p_weaken_enemy_detonation_effect.alo	Missing	['Particles.xml']
p_explosion_tiny00_dud.alo	Missing	['Particles.xml']
p_explosion_med00_dud.alo	Missing	['Particles.xml']
p_desert_ground_puff.alo	Missing	['Particles.xml']
p_shield_blast_small00.alo	Missing	['Particles.xml']
p_shield_blast_med00.alo	Missing	['Particles.xml']
p_shield_blast_large00.alo	Missing	['Particles.xml']
p_shield_large01.alo	Missing	['Particles.xml']
p_explosion_empire_med00_no_debris.alo	Missing	['Particles.xml']
p_ataa_footpuff_default.alo	Missing	['Particles.xml']
p_atat_footpuff_dirt.alo	Missing	['Particles.xml']
p_splash_wake.alo	Missing	['Particles.xml']
p_atat_footpuff_grass.alo	Missing	['Particles.xml']
p_atat_footpuff_snow.alo	Missing	['Particles.xml']
p_explosion_thermal_small00.alo	Missing	['Particles.xml']
p_explosion_flak01.alo	Missing	['Particles.xml']
p_rain_splash.alo	Missing	['Particles.xml']
p_splash_bullet.alo	Missing	['Particles.xml']
p_splash_wake_continuous.alo	Missing	['Particles.xml']
p_splash_wake_lava.alo	Missing	['Particles.xml']
p_ice_ground_puff.alo	Missing	['Particles.xml']
p_landing_dust_temperate.alo	Missing	['Particles.xml']
p_landing_dust_snow.alo	Missing	['Particles.xml']
p_landing_dust_desert.alo	Missing	['Particles.xml']
p_landing_dust_forest.alo	Missing	['Particles.xml']
p_landing_dust_swamp.alo	Missing	['Particles.xml']
p_landing_dust_volcanic.alo	Missing	['Particles.xml']
p_landing_dust_urban.alo	Missing	['Particles.xml']
p_magnepulse_damage00.alo	Missing	['Particles.xml']
p_heal00.alo	Missing	['Particles.xml']
p_force_distract.alo	Missing	['Particles.xml']
p_stun_fx.alo	Missing	['Particles.xml']
p_corrupt_fx.alo	Missing	['Particles.xml']
p_tani_stun.alo	Missing	['Particles.xml']
p_instant_heal.alo	Missing	['Particles.xml']
p_force_push.alo	Missing	['Particles.xml']
p_force_whirlwind.alo	Missing	['Particles.xml']
p_force_convert.alo	Missing	['Particles.xml']
p_lure_object_particle_effect.alo	Missing	['Particles.xml']
p_at-at_powerup.alo	Missing	['Particles.xml']
p_piet_powerup.alo	Missing	['Particles.xml']
p_replenish_wingmen_particle_effect.alo	Missing	['Particles.xml']
p_weaken_enemy_particle_effect.alo	Missing	['Particles.xml']
p_telekenesis_attack.alo	Missing	['Particles.xml']
p_home_one_target.alo	Missing	['Particles.xml']
p_stealing.alo	Missing	['Particles.xml']
p_smoke_small01.alo	Missing	['Particles.xml']
p_smoke_small02.alo	Missing	['Particles.xml']
p_smoke_small00.alo	Missing	['Particles.xml']
p_smoke_med01.alo	Missing	['Particles.xml']
p_smoke_med00.alo	Missing	['Particles.xml']
p_smoke_big01.alo	Missing	['Particles.xml']
p_smoke_big00.alo	Missing	['Particles.xml']
p_shield_small01.alo	Missing	['Particles.xml']
p_shield_med01.alo	Missing	['Particles.xml']
p_bothan_stun_explosion.alo	Missing	['Particles.xml']
p_dazed.alo	Missing	['Particles.xml']
p_invulnerable00.alo	Missing	['Particles.xml']
p_planet_explode_300.alo	Missing	['Particles.xml']
p_fire_small00.alo	Missing	['Particles.xml']
p_fire_med00.alo	Missing	['Particles.xml']
p_fire_big00.alo	Missing	['Particles.xml']
p_fire_huge00.alo	Missing	['Particles.xml']
p_fire_empire_small00.alo	Missing	['Particles.xml']
p_fire_empire_med00.alo	Missing	['Particles.xml']
p_fire_empire_big00.alo	Missing	['Particles.xml']
p_fire_empire_huge00.alo	Missing	['Particles.xml']
p_girder_dust_med00.alo	Missing	['Particles.xml']
p_antilles_rescue.alo	Missing	['Particles.xml']
p_fire_med01.alo	Missing	['Particles.xml']
w_pick_up_coins.alo	Missing	['Particles.xml']
w_planet_asteroids.alo	Missing	['Planets.xml', 'planets2.xml', 'planets2.xml', 'planets2.xml', 'planets2.xml', 'planets2.xml', 'planets2.xml', 'planets2.xml', 'planets2.xml', 'planets2.xml', 'planets2.xml', 'planets2.xml', 'planets2.xml', 'planets2.xml', 'planets2.xml', 'planets2.xml', 'planets2.xml', 'planets2.xml', 'planets2.xml', 'planets2.xml', 'planets2.xml', 'planets2.xml', 'planets2.xml', 'planets2.xml', 'planets2.xml', 'planets2.xml', 'planets2.xml', 'planets2.xml', 'planets2.xml', 'planets2.xml', 'planets2.xml', 'planets2.xml', 'planets2.xml', 'planets2.xml', 'planets2.xml', 'planets2.xml', 'planets2.xml', 'planets2.xml', 'planets2.xml', 'planets2.xml', 'planets2.xml', 'planets2.xml', 'planets2.xml', 'planets2.xml', 'planets2.xml', 'planets2.xml', 'planets2.xml', 'planets2.xml', 'planets2.xml', 'planets2.xml', 'planets2.xml', 'planets2.xml', 'planets2.xml', 'planets2.xml', 'planets2.xml', 'planets2.xml', 'planets2.xml', 'planets2.xml', 'planets2.xml', 'planets2.xml', 'planets2.xml', 'planets2.xml', 'planets2.xml', 'planets2.xml', 'planets2.xml', 'planets2.xml', 'planets2.xml', 'planets2.xml', 'planets2.xml', 'planets2.xml', 'planets2.xml', 'planets2.xml', 'planets2.xml', 'planets2.xml', 'planets2.xml', 'planets2.xml', 'planets2.xml', 'planets2.xml', 'planets2.xml', 'planets2.xml', 'planets2.xml', 'planets2.xml', 'planets2.xml', 'planets2.xml', 'planets2.xml', 'planets2.xml', 'planets2.xml', 'planets2.xml', 'planets2.xml', 'planets2.xml', 'planets2.xml', 'planets2.xml', 'planets2.xml', 'planets2.xml', 'planets2.xml', 'planets2.xml', 'planets2.xml', 'planets2.xml', 'planets2.xml', 'planets2.xml', 'planets2.xml', 'planets2.xml', 'planets2.xml', 'planets2.xml', 'planets2.xml', 'planets2.xml', 'planets2.xml', 'planets2.xml', 'planets2.xml', 'planets2.xml', 'planets2.xml', 'planets2.xml', 'planets2.xml', 'planets2.xml', 'planets2.xml', 'planets2.xml', 'planets2.xml', 'planets2.xml', 'planets2.xml', 'planets2.xml', 'planets2.xml', 'planets2.xml', 'planets2.xml', 'planets2.xml', 'planets2.xml', 'planets2.xml', 'planets2.xml', 'planets2.xml', 'planets2.xml', 'planets2.xml', 'planets2.xml', 'planets2.xml', 'planets2.xml', 'planets2.xml', 'planets2.xml', 'planets2.xml', 'planets2.xml', 'planets2.xml', 'planets2.xml', 'planets2.xml', 'planets2.xml', 'planets2.xml', 'planets2.xml', 'planets2.xml', 'planets2.xml', 'planets2.xml', 'planets2.xml', 'planets2.xml', 'planets2.xml', 'planets2.xml', 'planets2.xml', 'planets2.xml', 'planets2.xml', 'planets2.xml', 'planets2.xml', 'planets2.xml', 'planets2.xml', 'planets2.xml', 'planets2.xml', 'planets2.xml', 'planets2.xml', 'planets2.xml', 'planets2.xml', 'planets2.xml', 'planets2.xml', 'planets2.xml', 'planets2.xml', 'planets2.xml', 'planets2.xml', 'planets2.xml', 'planets2.xml', 'planets2.xml', 'planets2.xml', 'planets2.xml', 'planets2.xml', 'planets2.xml', 'planets2.xml', 'planets2.xml', 'planets2.xml', 'planets2.xml', 'planets2.xml', 'planets2.xml', 'planets2.xml', 'planets2.xml', 'planets2.xml', 'planets2.xml', 'planets2.xml', 'planets2.xml', 'planets2.xml', 'planets2.xml', 'planets2.xml', 'planets2.xml', 'planets2.xml', 'planets2.xml', 'planets2.xml', 'planets2.xml', 'planets2.xml', 'planets2.xml', 'planets2.xml', 'planets2.xml', 'planets2.xml', 'planets2.xml', 'planets2.xml', 'planets2.xml', 'planets2.xml', 'planets2.xml', 'planets2.xml', 'planets2.xml', 'planets2.xml', 'planets2.xml', 'planets2.xml', 'planets2.xml', 'planets2.xml', 'planets2.xml', 'planets2.xml', 'planets2.xml', 'planets2.xml', 'planets2.xml', 'planets2.xml', 'planets2.xml', 'planets2.xml', 'planets2.xml', 'planets2.xml', 'planets2.xml', 'planets2.xml', 'planets2.xml', 'planets2.xml', 'planets2.xml', 'planets2.xml', 'planets2.xml', 'planets2.xml', 'planets2.xml', 'planets2.xml', 'planets2.xml', 'planets2.xml', 'planets2.xml', 'planets2.xml', 'planets2.xml', 'planets2.xml', 'planets2.xml', 'planets2.xml', 'planets2.xml', 'planets2.xml', 'planets2.xml', 'planets2.xml', 'planets2.xml', 'planets2.xml', 'planets2.xml', 'planets2.xml', 'planets2.xml', 'planets2.xml', 'planets2.xml', 'planets2.xml', 'planets2.xml', 'planets2.xml', 'planets2.xml', 'planets2.xml', 'planets2.xml', 'planets2.xml', 'planets2.xml', 'planets2.xml', 'planets2.xml', 'planets2.xml', 'planets2.xml', 'planets2.xml', 'planets2.xml', 'planets2.xml', 'planets2.xml', 'planets2.xml', 'planets2.xml', 'planets2.xml', 'planets2.xml', 'planets2.xml', 'planets2.xml', 'planets2.xml', 'planets2.xml', 'planets2.xml', 'planets2.xml', 'planets2.xml', 'planets2.xml', 'planets2.xml', 'planets2.xml', 'planets2.xml', 'planets2.xml', 'planets2.xml', 'planets2.xml', 'planets2.xml', 'planets2.xml', 'planets2.xml', 'planets2.xml', 'planets2.xml', 'planets2.xml', 'planets2.xml', 'planets2.xml', 'planets2.xml', 'planets2.xml', 'planets2.xml', 'planets2.xml', 'planets2.xml', 'planets2.xml', 'planets2.xml', 'planets2.xml', 'planets2.xml', 'planets2.xml', 'planets2.xml', 'planets2.xml', 'planets2.xml', 'planets2.xml', 'planets2.xml', 'planets2.xml', 'planets2.xml', 'planets2.xml', 'planets2.xml', 'planets2.xml', 'planets2.xml', 'planets2.xml', 'planets2.xml', 'planets2.xml', 'planets2.xml', 'planets2.xml', 'planets2.xml', 'planets2.xml', 'planets2.xml', 'planets2.xml', 'planets2.xml', 'planets2.xml', 'planets_dummy.xml', 'planets_dummy.xml', 'planets_dummy.xml', 'planets_dummy.xml', 'planets_dummy.xml', 'planets_dummy.xml', 'planets_dummy.xml', 'planets_dummy.xml', 'planets_dummy.xml', 'planets_dummy.xml']
w_planet_sphere_temperate01.alo	Missing	['Planets2.xml']
w_planet_sphere_abridon.alo	Missing	['Planets2.xml']
w_planet_sphere_temperate02.alo	Missing	['Planets2.xml']
w_planet_sphere_ajan_kloss.alo	Missing	['Planets2.xml']
w_planet_sphere_ice.alo	Missing	['Planets2.xml']
w_planet_sphere_temperate03.alo	Missing	['Planets2.xml']
w_planet_sphere_temperate04.alo	Missing	['Planets2.xml']
w_planet_sphere_ando.alo	Missing	['Planets2.xml']
w_planet_sphere_artesia.alo	Missing	['Planets2.xml']
w_planet_sphere_ansion.alo	Missing	['Planets2.xml']
w_planet_sphere_ice01.alo	Missing	['Planets2.xml']
w_planet_sphere_desert.alo	Missing	['Planets2.xml']
w_planet_sphere_ocean.alo	Missing	['Planets2.xml']
w_planet_sphere_barab.alo	Missing	['Planets2.xml']
w_planet_sphere_swamp.alo	Missing	['Planets2.xml']
w_planet_sphere_vulcanic01.alo	Missing	['Planets2.xml']
w_planet_sphere_batuu.alo	Missing	['Planets2.xml']
w_planet_sphere_desert01.alo	Missing	['Planets2.xml']
w_planet_sphere_belgaroth.alo	Missing	['Planets2.xml']
w_planet_sphere_eriadu01.alo	Missing	['Planets2.xml']
w_planet_sphere_ice02.alo	Missing	['Planets2.xml']
w_planet_sphere_caamas.alo	Missing	['Planets2.xml']
w_planet_sphere_forest01.alo	Missing	['Planets2.xml']
w_planet_sphere_ice03.alo	Missing	['Planets2.xml']
w_planet_sphere_urban.alo	Missing	['Planets2.xml']
w_planet_sphere_centares.alo	Missing	['Planets2.xml']
w_planet_sphere_cerea.alo	Missing	['Planets2.xml']
w_planet_sphere_champala.alo	Missing	['Planets2.xml']
w_planet_sphere_forest02.alo	Missing	['Planets2.xml']
w_planet_sphere_urban01.alo	Missing	['Planets2.xml']
w_planet_sphere_ciutric.alo	Missing	['Planets2.xml']
w_planet_sphere_forest03.alo	Missing	['Planets2.xml']
w_planet_sphere_swamp01.alo	Missing	['Planets2.xml']
w_planet_sphere_concord_dawn.alo	Missing	['Planets2.xml']
w_planet_sphere_swamp02.alo	Missing	['Planets2.xml']
w_planet_sphere_corsin.alo	Missing	['Planets2.xml']
w_planet_sphere_swamp03.alo	Missing	['Planets2.xml']
w_planet_sphere_cularin.alo	Missing	['Planets2.xml']
w_planet_sphere_daalang.alo	Missing	['Planets2.xml']
w_planet_sphere_dellalt.alo	Missing	['Planets2.xml']
w_planet_sphere_desert02.alo	Missing	['Planets2.xml']
w_planet_sphere_desevro.alo	Missing	['Planets2.xml']
w_planet_sphere_druckenwell.alo	Missing	['Planets2.xml']
w_planet_sphere_dorin.alo	Missing	['Planets2.xml']
w_planet_sphere_dubrillion.alo	Missing	['Planets2.xml']
w_planet_sphere_desert03.alo	Missing	['Planets2.xml']
w_planet_sphere_temperate.alo	Missing	['Planets2.xml']
w_planet_sphere_foless.alo	Missing	['Planets2.xml']
w_planet_sphere_forest04.alo	Missing	['Planets2.xml']
w_planet_sphere_gamorr.alo	Missing	['Planets2.xml']
w_planet_sphere_garos.alo	Missing	['Planets2.xml']
w_planet_sphere_garqi.alo	Missing	['Planets2.xml']
w_planet_sphere_generis.alo	Missing	['Planets2.xml']
w_planet_sphere_forest.alo	Missing	['Planets2.xml']
w_planet_sphere_helska.alo	Missing	['Planets2.xml']
w_planet_sphere_kalist.alo	Missing	['Planets2.xml']
w_planet_sphere_ketaris.alo	Missing	['Planets2.xml']
w_planet_sphere_kothlis.alo	Missing	['Planets2.xml']
w_planet_sphere_lothal.alo	Missing	['Planets2.xml']
w_planet_sphere_lwhekk.alo	Missing	['Planets2.xml']
w_planet_sphere_metellos.alo	Missing	['Planets2.xml']
w_planet_sphere_nelvaan.alo	Missing	['Planets2.xml']
w_planet_sphere_nkllon.alo	Missing	['Planets2.xml']
w_planet_sphere_oba_diah.alo	Missing	['Planets2.xml']
w_planet_sphere_obroa_skai.alo	Missing	['Planets2.xml']
w_planet_sphere_ord_trasi.alo	Missing	['Planets2.xml']
w_planet_sphere_orinda.alo	Missing	['Planets2.xml']
w_planet_sphere_pantolomin.alo	Missing	['Planets2.xml']
w_planet_sphere_phaeda.alo	Missing	['Planets2.xml']
w_planet_sphere_pillio.alo	Missing	['Planets2.xml']
w_planet_sphere_sarapin.alo	Missing	['Planets2.xml']
w_planet_sphere_togoria.alo	Missing	['Planets2.xml']
w_planet_sphere_polus.alo	Missing	['Planets2.xml']
w_planet_sphere_wistril.alo	Missing	['Planets2.xml']
w_planet_sphere_woostri.alo	Missing	['Planets2.xml']
w_planet_sphere_ylesia.alo	Missing	['Planets2.xml']
w_planet_sphere_zygerria.alo	Missing	['Planets2.xml']
w_planet_sphere_ziost.alo	Missing	['Planets2.xml']
w_planet_sphere_zakuul.alo	Missing	['Planets2.xml']
w_planet_sphere_yagdhull.alo	Missing	['Planets2.xml']
w_planet_sphere_yavin_system.alo	Missing	['Planets2.xml']
w_planet_sphere_wobani.alo	Missing	['Planets2.xml']
w_planet_sphere_wayland.alo	Missing	['Planets2.xml']
w_planet_sphere_vulpter.alo	Missing	['Planets2.xml']
w_planet_sphere_vardos.alo	Missing	['Planets2.xml']
w_planet_sphere_utapau.alo	Missing	['Planets2.xml']
w_planet_sphere_umbara.alo	Missing	['Planets2.xml']
w_planet_sphere_trandosha.alo	Missing	['Planets2.xml']
w_planet_sphere_tython.alo	Missing	['Planets2.xml']
w_planet_sphere_ocean02.alo	Missing	['Planets2.xml']
w_planet_black_hole.alo	Missing	['Planets2.xml']
w_planet_sphere_teth.alo	Missing	['Planets2.xml']
w_planet_sphere_terminus.alo	Missing	['Planets2.xml']
w_planet_sphere_telos.alo	Missing	['Planets2.xml']
w_planet_sphere_tatooine.alo	Missing	['Planets2.xml']
w_planet_sphere_takodana.alo	Missing	['Planets2.xml']
w_planet_sphere_taris.alo	Missing	['Planets2.xml']
w_planet_sphere_taspir.alo	Missing	['Planets2.xml']
w_planet_sphere_skako.alo	Missing	['Planets2.xml']
w_planet_sphere_sullust.alo	Missing	['Planets2.xml']
w_planet_sphere_starkillerbase.alo	Missing	['Planets2.xml']
w_planet_sphere_serenno.alo	Missing	['Planets2.xml']
w_planet_sphere_scarif.alo	Missing	['Planets2.xml']
w_planet_sphere_savareen.alo	Missing	['Planets2.xml']
w_planet_sphere_rendili.alo	Missing	['Planets2.xml']
w_planet_sphere_ryloth.alo	Missing	['Planets2.xml']
w_planet_sphere_ringovinda.alo	Missing	['Planets2.xml']
w_planet_sphere_raxus.alo	Missing	['Planets2.xml']
w_planet_sphere_rattatak.alo	Missing	['Planets2.xml']
w_planet_sphere_raydonia.alo	Missing	['Planets2.xml']
w_planet_sphere_rodia.alo	Missing	['Planets2.xml']
w_planet_sphere_ruusan.alo	Missing	['Planets2.xml']
w_planet_sphere_rishi.alo	Missing	['Planets2.xml']
w_planet_sphere_rentor.alo	Missing	['Planets2.xml']
w_planet_sphere_gas_red.alo	Missing	['Planets2.xml']
w_planet_sphere_rothana.alo	Missing	['Planets2.xml']
w_planet_sphere_randon.alo	Missing	['Planets2.xml']
w_planet_sphere_ralltiir.alo	Missing	['Planets2.xml']
w_planet_sphere_pantora.alo	Missing	['Planets2.xml']
w_planet_sphere_ossus.alo	Missing	['Planets2.xml']
w_planet_sphere_ordmantell.alo	Missing	['Planets2.xml']
w_planet_sphere_onderon.alo	Missing	['Planets2.xml']
w_planet_sphere_nevarro.alo	Missing	['Planets2.xml']
w_planet_sphere_naboo.alo	Missing	['Planets2.xml']
w_planet_sphere_nalhutta.alo	Missing	['Planets2.xml']
w_planet_sphere_malastare.alo	Missing	['Planets2.xml']
w_planet_sphere_ocean03.alo	Missing	['Planets2.xml']
w_planet_sphere_malachor.alo	Missing	['Planets2.xml']
w_planet_sphere_muunilinst.alo	Missing	['Planets2.xml']
w_planet_sphere_myrkr.alo	Missing	['Planets2.xml']
w_planet_sphere_desert04.alo	Missing	['Planets2.xml']
w_planet_sphere_vulcanic.alo	Missing	['Planets2.xml']
w_planet_sphere_mygeeto.alo	Missing	['Planets2.xml']
w_planet_sphere_mustafar.alo	Missing	['Planets2.xml']
w_planet_sphere_mandalore.alo	Missing	['Planets2.xml']
w_planet_sphere_loronar.alo	Missing	['Planets2.xml']
w_planet_sphere_lehon.alo	Missing	['Planets2.xml']
w_planet_sphere_lahmu.alo	Missing	['Planets2.xml']
w_planet_sphere_kuat.alo	Missing	['Planets2.xml']
w_planet_sphere_kalee.alo	Missing	['Planets2.xml']
w_planet_sphere_korriban.alo	Missing	['Planets2.xml']
w_planet_sphere_kessel.alo	Missing	['Planets2.xml']
w_planet_sphere_kamino.alo	Missing	['Planets2.xml']
w_planet_sphere_jedha_system.alo	Missing	['Planets2.xml']
w_planet_sphere_jakku.alo	Missing	['Planets2.xml']
w_planet_sphere_jabiim.alo	Missing	['Planets2.xml']
w_planet_sphere_iridonia.alo	Missing	['Planets2.xml']
w_planet_sphere_ilum.alo	Missing	['Planets2.xml']
w_planet_sphere_ithor.alo	Missing	['Planets2.xml']
w_planet_sphere_hosnianprime.alo	Missing	['Planets2.xml']
w_planet_sphere_gleeanselm.alo	Missing	['Planets2.xml']
w_planet_sphere_geonosis_rings.alo	Missing	['Planets2.xml']
w_planet_sphere_foerost.alo	Missing	['Planets2.xml']
w_planet_sphere_fondor.alo	Missing	['Planets2.xml']
w_planet_sphere_florrum.alo	Missing	['Planets2.xml']
w_planet_sphere_ferrix.alo	Missing	['Planets2.xml']
w_planet_sphere_felucia.alo	Missing	['Planets2.xml']
w_planet_sphere_falleen.alo	Missing	['Planets2.xml']
w_planet_sphere_exogol.alo	Missing	['Planets2.xml']
w_planet_sphere_eriadu.alo	Missing	['Planets2.xml']
w_planet_sphere_endor_system.alo	Missing	['Planets2.xml']
w_planet_sphere_eadu.alo	Missing	['Planets2.xml']
w_planet_sphere_dqar.alo	Missing	['Planets2.xml']
w_planet_sphere_dromundkaas.alo	Missing	['Planets2.xml']
w_planet_sphere_dathomir.alo	Missing	['Planets2.xml']
w_planet_sphere_dagobah.alo	Missing	['Planets2.xml']
w_planet_sphere_carida.alo	Missing	['Planets2.xml']
w_planet_sphere_csilla.alo	Missing	['Planets2.xml']
w_planet_sphere_crait.alo	Missing	['Planets2.xml']
w_planet_sphere_coruscant.alo	Missing	['Planets2.xml']
w_planet_sphere_christophsis.alo	Missing	['Planets2.xml']
w_planet_sphere_corellia.alo	Missing	['Planets2.xml']
w_planet_sphere_commenor.alo	Missing	['Planets2.xml']
w_planet_sphere_catoneimodia.alo	Missing	['Planets2.xml']
w_planet_sphere_cantonica.alo	Missing	['Planets2.xml']
w_planet_sphere_bandomeer.alo	Missing	['Planets2.xml']
w_planet_sphere_byss.alo	Missing	['Planets2.xml']
w_planet_sphere_brakka.alo	Missing	['Planets2.xml']
w_planet_sphere_bozpity.alo	Missing	['Planets2.xml']
w_planet_sphere_bothawui_system.alo	Missing	['Planets2.xml']
w_planet_sphere_brentaal.alo	Missing	['Planets2.xml']
w_planet_sphere_bimmiel.alo	Missing	['Planets2.xml']
w_planet_sphere_bilbringi.alo	Missing	['Planets2.xml']
w_planet_sphere_bestine.alo	Missing	['Planets2.xml']
w_planet_sphere_bespin.alo	Missing	['Planets2.xml']
w_planet_sphere_belkadan.alo	Missing	['Planets2.xml']
w_planet_sphere_borleias.alo	Missing	['Planets2.xml']
w_planet_sphere_bonadan.alo	Missing	['Planets2.xml']
w_planet_sphere_ocean01.alo	Missing	['Planets2.xml']
w_planet_sphere_balmorra.alo	Missing	['Planets2.xml']
w_planet_sphere_alakatha.alo	Missing	['Planets2.xml']
w_planet_sphere_ambria.alo	Missing	['Planets2.xml']
w_planet_sphere_agamar.alo	Missing	['Planets2.xml']
w_planet_sphere_alsakan.alo	Missing	['Planets2.xml']
w_planet_sphere_axxila.alo	Missing	['Planets2.xml']
w_planet_sphere_alarisprime.alo	Missing	['Planets2.xml']
w_planet_sphere_anoat.alo	Missing	['Planets2.xml']
w_planet_sphere_anaxes.alo	Missing	['Planets2.xml']
w_planet_sphere_alderaan.alo	Missing	['Planets2.xml']
w_planet_sphere_aeten.alo	Missing	['Planets2.xml']
w_planet_sphere_achcto.alo	Missing	['Planets2.xml']
w_planet_sphere_aargau.alo	Missing	['Planets2.xml']
w_planet_eriadu_low.alo	Missing	['Planets_Dummy.xml']
w_planet_temperate01.alo	Missing	['Planets_Dummy.xml']
w_laser_small.alo	Missing	['Projectiles.xml']
w_laser_smallg.alo	Missing	['Projectiles.xml']
w_laser_medium.alo	Missing	['Projectiles.xml']
p_lucky.alo	Missing	['Projectiles.xml']
pion_ioncannonshot.alo	Missing	['Projectiles.xml']
w_laser_mediumg.alo	Missing	['Projectiles.xml']
w_laser_large.alo	Missing	['Projectiles.xml']
w_laser_largeg.alo	Missing	['Projectiles.xml']
w_concussion_missile.alo	Missing	['Projectiles.xml', 'projectiles_land.xml', 'projectiles_space.xml']
w_ewok_rock.alo	Missing	['Projectiles.xml']
w_gungan_projectile.alo	Missing	['Projectiles.xml']
w_flack_pod.alo	Missing	['Projectiles.xml']
w_proton_projectile.alo	Missing	['Projectiles.xml']
p_spmat_shot.alo	Missing	['Projectiles.xml']
p_hyper_gun_slug.alo	Missing	['Projectiles.xml']
p_ion_cannon00.alo	Missing	['Projectiles.xml']
p_turbolaser_burst_med00_green.alo	Missing	['Projectiles.xml']
p_turbolaser_burst_med00.alo	Missing	['Projectiles.xml']
w_thermal_detonator.alo	Missing	['Projectiles.xml']
w_thermal_detonator_empire.alo	Missing	['Projectiles.xml']
w_thermal_detonator_rebel.alo	Missing	['Projectiles.xml']
p_seismic_bomb00.alo	Missing	['Projectiles.xml']
w_smallbomb.alo	Missing	['Projectiles.xml']
p_flamethrower00.alo	Missing	['Projectiles_Land.xml']
w_infantry_blaster_lightblue.alo	Missing	['Projectiles_Land.xml']
w_super_heavy_turbolaser_b_front.alo	Missing	['Projectiles_Space.xml']
w_super_heavy_turbolaser_g_front.alo	Missing	['Projectiles_Space.xml']
w_ship_turbolaser_bluee6.alo	Missing	['Projectiles_Space.xml']
w_fighter_turbolaser_r.alo	Missing	['Projectiles_Space.xml']
w_fighter_turbolaser_p.alo	Missing	['Projectiles_Space.xml']
w_fighter_turbolaser_y.alo	Missing	['Projectiles_Space.xml']
w_fighter_turbolaser_b.alo	Missing	['Projectiles_Space.xml']
w_fighter_turbolaser_i.alo	Missing	['Projectiles_Space.xml']
w_ship_turbolaser_r1.alo	Missing	['Projectiles_Space.xml']
w_spaceprop_desert.alo	Missing	['Spaceprops_R.O.T.E.xml']
w_spaceprop_desert01.alo	Missing	['Spaceprops_R.O.T.E.xml']
w_spaceprop_forest.alo	Missing	['Spaceprops_R.O.T.E.xml']
w_spaceprop_forest01.alo	Missing	['Spaceprops_R.O.T.E.xml']
w_spaceprop_ice.alo	Missing	['Spaceprops_R.O.T.E.xml']
w_spaceprop_ice01.alo	Missing	['Spaceprops_R.O.T.E.xml']
w_spaceprop_ocean.alo	Missing	['Spaceprops_R.O.T.E.xml']
w_spaceprop_swamp.alo	Missing	['Spaceprops_R.O.T.E.xml']
w_spaceprop_swamp01.alo	Missing	['Spaceprops_R.O.T.E.xml']
w_spaceprop_temperate.alo	Missing	['Spaceprops_R.O.T.E.xml']
w_spaceprop_temperate01.alo	Missing	['Spaceprops_R.O.T.E.xml']
w_spaceprop_urban.alo	Missing	['Spaceprops_R.O.T.E.xml']
w_spaceprop_urban01.alo	Missing	['Spaceprops_R.O.T.E.xml']
w_spaceprop_volcanic.alo	Missing	['Spaceprops_R.O.T.E.xml']
w_spaceprop_volcanic01.alo	Missing	['Spaceprops_R.O.T.E.xml']
rb_ioncannon.alo	Missing	['Specialstructures.xml']
nb_commjamstation.alo	Missing	['Specialstructures.xml']
nb_commjamstation_d.alo	Missing	['Specialstructures.xml']
nb_shuttershieldgen.alo	Missing	['Specialstructures.xml']
nb_spacesensornode.alo	Missing	['Specialstructures.xml']
w_cantinatat.alo	Missing	['Specialstructures.xml']
w_huttpalace.alo	Missing	['Specialstructures.xml']
nb_grandarena.alo	Missing	['Specialstructures.xml']
rb_barracks.alo	Missing	['Specialstructures.xml']
nb_cmc22mining.alo	Missing	['Specialstructures.xml', 'specialstructures_underworld.xml', 'specialstructures_banking_clan.xml', 'specialstructures_black_sun.xml', 'specialstructures_cis_remnant.xml', 'specialstructures_commerce_guild.xml', 'specialstructures_corporate_sector.xml', 'specialstructures_crimson_dawn.xml', 'specialstructures_early_empire.xml', 'specialstructures_first_order.xml', 'specialstructures_galactic_empire.xml', 'specialstructures_hapan_consortium.xml', 'specialstructures_hutt_cartel.xml', 'specialstructures_imperial_remnant.xml', 'specialstructures_mandalorians.xml', 'specialstructures_new_republic.xml', 'specialstructures_pyke_syndicate.xml', 'specialstructures_rebel_alliance.xml', 'specialstructures_remnant_adelhard.xml', 'specialstructures_remnant_gratloe.xml', 'specialstructures_remnant_loring.xml', 'specialstructures_remnant_rax.xml', 'specialstructures_remnant_thrawn.xml', 'specialstructures_techno_union.xml', 'specialstructures_terrorists.xml', 'specialstructures_trade_federation.xml']
rb_officeracademy.alo	Missing	['Specialstructures.xml']
nb_prison.alo	Missing	['Specialstructures.xml']
w_asteroid02.alo	Missing	['Specialstructures.xml']
w_asteroid00.alo	Missing	['Specialstructures.xml']
w_asteroid01.alo	Missing	['Specialstructures.xml']
w_asteroid03.alo	Missing	['Specialstructures.xml']
nv_defensesatellite.alo	Missing	['Specialstructures.xml']
nv_mds.alo	Missing	['Specialstructures.xml']
nv_lds.alo	Missing	['Specialstructures.xml']
nb_cmc22mining_sml.alo	Missing	['Specialstructures.xml']
empire_shieldgate_lvl5_gc.alo	Missing	['Starbases_Empire.xml', 'starbases_banking_clan.xml', 'starbases_banking_clan.xml', 'starbases_banking_clan.xml', 'starbases_banking_clan.xml', 'starbases_banking_clan.xml', 'starbases_banking_clan.xml', 'starbases_black_sun.xml', 'starbases_black_sun.xml', 'starbases_black_sun.xml', 'starbases_black_sun.xml', 'starbases_black_sun.xml', 'starbases_black_sun.xml', 'starbases_cis_remnant.xml', 'starbases_cis_remnant.xml', 'starbases_cis_remnant.xml', 'starbases_cis_remnant.xml', 'starbases_cis_remnant.xml', 'starbases_cis_remnant.xml', 'starbases_commerce_guild.xml', 'starbases_commerce_guild.xml', 'starbases_commerce_guild.xml', 'starbases_commerce_guild.xml', 'starbases_commerce_guild.xml', 'starbases_commerce_guild.xml', 'starbases_corporate_sector.xml', 'starbases_corporate_sector.xml', 'starbases_corporate_sector.xml', 'starbases_corporate_sector.xml', 'starbases_corporate_sector.xml', 'starbases_corporate_sector.xml', 'starbases_crimson_dawn.xml', 'starbases_crimson_dawn.xml', 'starbases_crimson_dawn.xml', 'starbases_crimson_dawn.xml', 'starbases_crimson_dawn.xml', 'starbases_crimson_dawn.xml', 'starbases_early_empire.xml', 'starbases_early_empire.xml', 'starbases_early_empire.xml', 'starbases_early_empire.xml', 'starbases_early_empire.xml', 'starbases_early_empire.xml', 'starbases_early_empire.xml', 'starbases_first_order.xml', 'starbases_first_order.xml', 'starbases_first_order.xml', 'starbases_first_order.xml', 'starbases_first_order.xml', 'starbases_first_order.xml', 'starbases_galactic_empire.xml', 'starbases_galactic_empire.xml', 'starbases_galactic_empire.xml', 'starbases_galactic_empire.xml', 'starbases_galactic_empire.xml', 'starbases_galactic_empire.xml', 'starbases_hapan_consortium.xml', 'starbases_hapan_consortium.xml', 'starbases_hapan_consortium.xml', 'starbases_hapan_consortium.xml', 'starbases_hapan_consortium.xml', 'starbases_hapan_consortium.xml', 'starbases_hutt_cartel.xml', 'starbases_hutt_cartel.xml', 'starbases_hutt_cartel.xml', 'starbases_hutt_cartel.xml', 'starbases_hutt_cartel.xml', 'starbases_hutt_cartel.xml', 'starbases_imperial_remnant.xml', 'starbases_imperial_remnant.xml', 'starbases_imperial_remnant.xml', 'starbases_imperial_remnant.xml', 'starbases_imperial_remnant.xml', 'starbases_imperial_remnant.xml', 'starbases_imperial_remnant_adelhard.xml', 'starbases_imperial_remnant_adelhard.xml', 'starbases_imperial_remnant_adelhard.xml', 'starbases_imperial_remnant_adelhard.xml', 'starbases_imperial_remnant_adelhard.xml', 'starbases_imperial_remnant_adelhard.xml', 'starbases_imperial_remnant_gratloe.xml', 'starbases_imperial_remnant_gratloe.xml', 'starbases_imperial_remnant_gratloe.xml', 'starbases_imperial_remnant_gratloe.xml', 'starbases_imperial_remnant_gratloe.xml', 'starbases_imperial_remnant_gratloe.xml', 'starbases_imperial_remnant_loring.xml', 'starbases_imperial_remnant_loring.xml', 'starbases_imperial_remnant_loring.xml', 'starbases_imperial_remnant_loring.xml', 'starbases_imperial_remnant_loring.xml', 'starbases_imperial_remnant_loring.xml', 'starbases_imperial_remnant_rax.xml', 'starbases_imperial_remnant_rax.xml', 'starbases_imperial_remnant_rax.xml', 'starbases_imperial_remnant_rax.xml', 'starbases_imperial_remnant_rax.xml', 'starbases_imperial_remnant_rax.xml', 'starbases_imperial_remnant_thrawn.xml', 'starbases_imperial_remnant_thrawn.xml', 'starbases_imperial_remnant_thrawn.xml', 'starbases_imperial_remnant_thrawn.xml', 'starbases_imperial_remnant_thrawn.xml', 'starbases_imperial_remnant_thrawn.xml', 'starbases_mandalorians.xml', 'starbases_mandalorians.xml', 'starbases_mandalorians.xml', 'starbases_mandalorians.xml', 'starbases_mandalorians.xml', 'starbases_mandalorians.xml', 'starbases_new_republic.xml', 'starbases_new_republic.xml', 'starbases_new_republic.xml', 'starbases_new_republic.xml', 'starbases_new_republic.xml', 'starbases_new_republic.xml', 'starbases_pyke_syndicate.xml', 'starbases_pyke_syndicate.xml', 'starbases_pyke_syndicate.xml', 'starbases_pyke_syndicate.xml', 'starbases_pyke_syndicate.xml', 'starbases_pyke_syndicate.xml', 'starbases_rebel_alliance.xml', 'starbases_rebel_alliance.xml', 'starbases_rebel_alliance.xml', 'starbases_rebel_alliance.xml', 'starbases_rebel_alliance.xml', 'starbases_rebel_alliance.xml', 'starbases_techno_union.xml', 'starbases_techno_union.xml', 'starbases_techno_union.xml', 'starbases_techno_union.xml', 'starbases_techno_union.xml', 'starbases_techno_union.xml', 'starbases_terrorists.xml', 'starbases_terrorists.xml', 'starbases_terrorists.xml', 'starbases_terrorists.xml', 'starbases_terrorists.xml', 'starbases_terrorists.xml', 'starbases_trade_federation.xml', 'starbases_trade_federation.xml', 'starbases_trade_federation.xml', 'starbases_trade_federation.xml', 'starbases_trade_federation.xml', 'starbases_trade_federation.xml']
ni_geonosian.alo	Missing	['Units_hero_BankingClan_San_Hill.xml', 'units_hero_cis_gizor_dellso.xml', 'units_hero_cis_gizor_dellso2.xml', 'units_hero_commerce_guild_shu_mai.xml', 'units_hero_remnant_rax_gallius_rax.xml', 'units_hero_mandalorians_bo_katan.xml', 'units_hero_technounion_wat_tambor.xml', 'units_hero_federation_sentepeth_findos.xml']
ri_r2.alo	Missing	['Units_land_cis_hackers.xml']
ri_c3po.alo	Missing	['Units_land_cis_hackers.xml']
cis_b1_grenadier_oom.alo	Missing	['Units_land_cis_BattleDroid_Grenadier.xml', 'units_land_commerce_battledroid_grenadier.xml', 'units_land_technounion_battledroid_grenadier.xml', 'units_land_federation_droid_grenadier.xml']
rv_moncalcruiser_d.alo	Missing	['Units_cis_Calamari_Cruiser.xml']
ei_palpatine.alo	Missing	['Units_hero_Early_Empire_Darth_Vader.xml', 'units_hero_early_empire_palpatine.xml']
ei_bobafett.alo	Missing	['Units_hero_Hutt_Cartel_Boba_Fett.xml']
ri_trooper_urban_quarren.alo	Missing	['Units_land_Hutts_Quarren_Bounty.xml']
new_republic_guard_trooper.alo	Missing	['Units_land_New_Republic_Guard_Trooper.xml']
ri_soldier_urban_human.alo	Missing	['Units_land_Rebel_Alliance_Soldier.xml']
space_facility.alo	Missing	['Specialstructures_Banking_Clan.xml', 'specialstructures_black_sun.xml', 'specialstructures_cis_remnant.xml', 'specialstructures_commerce_guild.xml', 'specialstructures_corporate_sector.xml', 'specialstructures_crimson_dawn.xml', 'specialstructures_early_empire.xml', 'specialstructures_first_order.xml', 'specialstructures_galactic_empire.xml', 'specialstructures_hapan_consortium.xml', 'specialstructures_hutt_cartel.xml', 'specialstructures_imperial_remnant.xml', 'specialstructures_mandalorians.xml', 'specialstructures_new_republic.xml', 'specialstructures_pyke_syndicate.xml', 'specialstructures_rebel_alliance.xml', 'specialstructures_remnant_adelhard.xml', 'specialstructures_remnant_gratloe.xml', 'specialstructures_remnant_loring.xml', 'specialstructures_remnant_rax.xml', 'specialstructures_remnant_thrawn.xml', 'specialstructures_techno_union.xml', 'specialstructures_terrorists.xml', 'specialstructures_trade_federation.xml']
nb_bothan_building.alo	Missing	['Specialstructures_Early_Empire.xml']
p_desert_ground_dust	Missing	['cis_bx_commando.alo', 'cis_bx_commando_captain.alo', 'ri_pilot.alo']
p_telekenesis	Missing	['ei_vader.alo']
p_bladecrash	Missing	['ei_vader.alo']
pe_imperial_star_destroyer_large	Missing	['empire_dominator.alo', 'empire_star_destroyer2.alo', 'empire_star_destroyeri.alo', 'empire_tector.alo', 'empire_vindicator.alo', 'engine.alo', 'ev_isd1.alo']
p_electricalstatic3	Missing	['ev_atar.alo', 'ev_at_dt.alo', 'ev_bike.alo', 'rv_snowspeeder.alo']
p_electricalstatic	Missing	['ev_atar.alo', 'ev_at_dt.alo', 'rv_snowspeeder.alo', 't2-b.alo']
p_smoke_small_thin	Missing	['ev_atar.alo', 'ev_at_dt.alo', 'rv_snowspeeder.alo', 't2-b.alo']
p_atst_die	Missing	['ev_at_dt.alo']
p_fire_small01	Missing	['ev_at_dt.alo']
p_smoke_small_sputter	Missing	['ev_at_dt.alo', 'ev_bike.alo', 'rv_snowspeeder.alo', 't2-b.alo']
pe_executor	Missing	['ev_executor_star_dreadnaught.alo']
pi_damage_elec_cap00	Missing	['ev_immobilizer.alo']
pi_damage_elec_sd00	Missing	['ev_immobilizer.alo', 'imperial_i-class_star_destroyer.alo']
p_hp_underworld_damage	Missing	['ev_immobilizer.alo']
p_rb_station_damage	Missing	['ev_immobilizer.alo']
pgw_grav_well	Missing	['ev_immobilizer.alo']
prs_interdict_fx	Missing	['ev_immobilizer.alo']
pe_tie_engine_land	Missing	['ev_tiestriker.alo']
pe_imperial-class_engines_large	Missing	['imperial_i-class_star_destroyer.alo']
pte_imperial-class_engines_large	Missing	['imperial_i-class_star_destroyer.alo']
pte_imperial-class_engines_small	Missing	['imperial_i-class_star_destroyer.alo']
pptw_ptwsa	Missing	['imperial_i-class_star_destroyer.alo']
p_boba_jetpack	Missing	['mi_death_watch_lieutenant.alo', 'ri_dyn_jarren_the_mandalorian.alo']
p_flamethrower00	Missing	['mi_death_watch_lieutenant.alo', 'ri_dyn_jarren_the_mandalorian.alo']
p_urai_blade_sparks	Missing	['ri_rebel_jedi_ahsoka_tano.alo']
pptw_strike	Missing	['rv_snowspeeder.alo']
p_electricalstatic2	Missing	['t2-b.alo']
p_galaxycore	Missing	['w_galaxy00.alo']
p_planet_deathstar_laser_large	Missing	['w_planet_deathstar02.alo']
p_planet_deathstar_laser_small	Missing	['w_planet_deathstar02.alo']
